year2,fage4,Firms,Estabs,Emp,Denom,Estabs_Entry,Estabs_Entry_Rate,Estabs_Exit,Estabs_Exit_Rate,Job_Creation,Job_Creation_Births,Job_Creation_Continuers,Job_Creation_Rate_Births,Job_Creation_Rate,Job_Destruction,Job_Destruction_Deaths,Job_Destruction_Continuers,Job_Destruction_Rate_Deaths,Job_Destruction_Rate,Net_Job_Creation,Net_Job_Creation_Rate,Reallocation_Rate,d_flag,firmdeath_firms,firmdeath_estabs,firmdeath_emp,sic1
1977,a) 0,564907,614710,3772499,1886250,603549,196.4,0,0,3717174,3717174,0,197.1,197.1,0,0,0,0,0,3717174,197.1,0,0,,,,
1977,l) Left Censored,2852958,3539061,62321738,62087494,94193,2.5,526008,14,10204558,2142894,8061664,3.5,16.4,9711055,3909354,5801701,6.3,15.6,493503,0.8,31.2,0,351016,353292,2.23E6,
1978,a) 0,504142,508610,2722496,1361248,503988,198.2,0,0,2709808,2709808,0,199.1,199.1,0,0,0,0,0,2709808,199.1,0,0,,,,
1978,b) 1,413120,465108,3723947,3751882,7137,1.3,150487,27.9,1106583,93249,1013334,2.5,29.5,1144055,676088,467967,18,30.5,-37472,-1,59,0,106764,107188,450987,
1978,l) Left Censored,2553079,3249026,63226352,62745591,115778,3.4,398485,11.7,10248882,1756479,8492403,2.8,16.3,9247056,3607558,5639498,5.7,14.7,1001826,1.6,29.4,0,253898,255698,1.68E6,
1979,a) 0,497889,503608,2862788,1431394,499123,198.2,0,0,2845613,2845613,0,198.8,198.8,0,0,0,0,0,2845613,198.8,0,0,,,,
1979,b) 1,390495,397391,2799811,2803825,2362,0.5,106732,23.5,851548,37209,814339,1.3,30.4,838297,443212,395085,15.8,29.9,13251,0.5,59.8,0,76142,76196,321310,
1979,c) 2,355881,407772,3631030,3673534,21087,4.8,74034,17,847759,157376,690383,4.3,23.1,921734,416902,504832,11.3,25.1,-73975,-2,46.2,0,47410,47571,239166,
1979,l) Left Censored,2354042,3067643,64728487,63952984,119222,3.8,291135,9.2,9898073,1955808,7942265,3.1,15.5,8307535,2778613,5528922,4.3,13,1590538,2.5,26,0,169817,171296,1.11E6,
1980,a) 0,451592,456172,2504689,1252345,451986,198.2,0,0,2491856,2491856,0,199,199,0,0,0,0,0,2491856,199,0,0,,,,
1980,b) 1,363844,371428,2622056,2770899,2162,0.5,114441,26.1,712410,41770,670640,1.5,25.7,909773,499881,409892,18,32.8,-197363,-7.1,51.4,0,92600,92697,411009,
1980,c) 2,319539,327528,2408962,2581759,12596,3.5,74518,20.6,516689,87944,428745,3.4,20,816636,393268,423368,15.2,31.6,-299947,-11.6,40,0,60108,60232,324527,
1980,d) 3,307595,358449,3442900,3532447,15387,4,62420,16.3,707034,151273,555761,4.3,20,877179,370473,506706,10.5,24.8,-170145,-4.8,40,0,43465,43758,233249,
1980,l) Left Censored,2164177,2885001,63777676,64260697,97970,3.3,272994,9.2,8294088,1797763,6496325,2.8,12.9,9187861,2684867,6502994,4.2,14.3,-893773,-1.4,25.8,0,175508,177049,1.16E6,
1981,a) 0,453532,456346,2961829,1480915,443758,194.5,0,0,2875892,2875892,0,194.2,194.2,0,0,0,0,0,2875892,194.2,0,0,,,,
1981,b) 1,331988,337463,2346588,2442691,2275,0.6,110158,27.8,669399,38367,631032,1.6,27.4,830727,500788,329939,20.5,34,-161328,-6.6,54.8,0,80315,80379,358702,
1981,c) 2,305986,314244,2427128,2506419,12046,3.5,74048,21.6,530426,91643,438783,3.7,21.2,762585,409012,353573,16.3,30.4,-232159,-9.2,42.4,0,53042,53114,289584,
1981,d) 3,268879,277002,2157748,2268970,10183,3.4,58974,19.6,420293,74658,345635,3.3,18.5,664597,320867,343730,14.1,29.3,-244304,-10.8,37,0,42775,42834,222853,
1981,e) 4,261919,305358,3061306,3225761,12998,3.9,62321,18.8,541424,127891,413533,4,16.8,858905,409777,449128,12.7,26.6,-317481,-9.8,33.6,0,34169,34505,187654,
1981,l) Left Censored,1944310,2650527,60588268,61641712,96260,3.5,303749,11,7726073,2006992,5719081,3.3,12.5,9770496,3395262,6375234,5.5,15.9,-2044423,-3.4,25,0,155699,157477,1.09E6,
1982,a) 0,448942,462120,3051386,1525693,459221,198.7,0,0,3019051,3019051,0,197.9,197.9,0,0,0,0,0,3019051,197.9,0,0,,,,
1982,b) 1,351052,363426,2957012,3014593,7630,1.9,92815,22.6,831544,121946,709598,4,27.6,915132,453745,461387,15.1,30.4,-83588,-2.8,55.2,0,64313,64315,322354,
1982,c) 2,280386,290546,2150639,2236008,18671,6,59261,18.9,549548,168967,380581,7.6,24.6,705672,326993,378679,14.6,31.6,-156124,-7,49.2,0,38315,38330,218608,
1982,d) 3,264717,279141,2229533,2317585,18741,6.3,49103,16.6,511705,179647,332058,7.8,22.1,673536,287400,386136,12.4,29.1,-161831,-7,44.2,0,31037,31049,185619,
1982,e) 4,233285,247425,2057286,2104324,15864,6,41070,15.6,483675,164096,319579,7.8,23,566766,228735,338031,10.9,26.9,-83091,-3.9,46,0,25005,25013,148124,
1982,f) 5,232981,284660,3026100,3058116,20961,7.1,38371,13,615603,217435,398168,7.1,20.1,669902,248319,421583,8.1,21.9,-54299,-1.8,40.2,0,20865,20930,124199,
1982,l) Left Censored,1792543,2543341,59002531,59770534,139171,5.4,224623,8.6,7707740,2382428,5325312,4,12.9,9184528,2508320,6676208,4.2,15.4,-1476788,-2.5,25.8,0,110498,111046,791898,
1983,a) 0,433661,439025,2503084,1251542,430850,196.3,0,0,2480805,2480805,0,198.2,198.2,0,0,0,0,0,2480805,198.2,0,0,,,,
1983,b) 1,341688,357926,2933044,3118163,2072,0.5,103337,25.1,852253,40249,812004,1.3,27.3,1206367,502383,703984,16.1,38.7,-354114,-11.4,54.6,0,77419,77612,378560,
1983,c) 2,298256,311224,2590094,2762422,10443,3.1,62016,18.4,509669,70017,439652,2.5,18.5,853354,379023,474331,13.7,30.9,-343685,-12.4,37,0,47051,47073,278072,
1983,d) 3,246399,256829,1944371,2047376,8874,3.2,44672,16.3,373410,48350,325060,2.4,18.2,584740,246273,338467,12,28.6,-211330,-10.4,36.4,0,32376,32450,184100,
1983,e) 4,237125,251285,2050407,2134336,8425,3.2,38693,14.6,380984,57082,323902,2.7,17.9,556280,227325,328955,10.7,26.1,-175296,-8.2,35.8,0,27376,27429,161936,
1983,f) 5,213774,228422,1871253,1964919,7736,3.3,30220,12.7,326452,55764,270688,2.8,16.6,520223,174941,345282,8.9,26.5,-193771,-9.9,33.2,0,21402,21476,121369,
1983,g) 6 to 10,216586,267702,2864753,2948896,10635,3.9,30995,11.2,473120,102375,370745,3.5,16,650044,217536,432508,7.4,22,-176924,-6,32,0,18307,18567,113204,
1983,l) Left Censored,1700631,2444285,55964546,57362280,91715,3.7,209618,8.4,7080093,1877536,5202557,3.3,12.3,9903860,2909536,6994324,5.1,17.3,-2823767,-5,24.6,0,104899,106270,731444,
1984,a) 0,503150,507512,2798883,1399442,504426,198.8,0,0,2788184,2788184,0,199.2,199.2,0,0,0,0,0,2788184,199.2,0,0,,,,
1984,b) 1,337848,345700,2649670,2631288,2520,0.6,92871,23.6,804371,61612,742759,2.3,30.6,757071,404413,352658,15.4,28.8,47300,1.8,57.6,0,66201,66223,303047,
1984,c) 2,289664,306140,2868763,2894307,12672,3.8,62127,18.7,670836,132659,538177,4.6,23.2,716078,354175,361903,12.2,24.7,-45242,-1.5,46.4,0,44179,44362,254302,
1984,d) 3,263091,276222,2620981,2607871,10313,3.5,45317,15.4,564250,73105,491145,2.8,21.6,536099,258258,277841,9.9,20.6,28151,1,41.2,0,32368,32429,186570,
1984,e) 4,222912,233238,1977186,1955424,9756,4,34378,14,424329,57184,367145,2.9,21.7,382153,181895,200258,9.3,19.5,42176,2.2,39,0,23671,23740,128086,
1984,f) 5,216690,230566,2032929,2019724,9715,4,31143,12.9,423087,60115,362972,3,20.9,398637,176559,222078,8.7,19.7,24450,1.2,39.4,0,21091,21159,117572,
1984,g) 6 to 10,399094,465573,4845351,4793463,20558,4.3,53087,11,915746,154286,761460,3.2,19.1,816644,311181,505463,6.5,17,99102,2.1,34,0,31785,32027,172283,
1984,l) Left Censored,1603764,2357763,57594641,56707506,96863,4,185342,7.7,8552117,2231697,6320420,3.9,15.1,6819091,2136838,4682253,3.8,12,1733026,3.1,24,0,90174,91159,596866,
1985,a) 0,509162,514869,2942849,1471425,511555,198.7,0,0,2928324,2928324,0,199,199,0,0,0,0,0,2928324,199,0,0,,,,
1985,b) 1,406042,413426,3166361,3098936,2612,0.6,92856,20.1,957788,71759,886029,2.3,30.9,806416,413164,393252,13.3,26,151372,4.9,52,0,66836,66851,306506,
1985,c) 2,286155,295505,2539580,2589951,13004,4.1,60349,18.8,613520,101062,512458,3.9,23.7,705866,341610,364256,13.2,27.3,-92346,-3.6,47.4,0,45545,45598,258246,
1985,d) 3,254546,271948,2721470,2792964,11473,4,45752,15.8,546969,98520,448449,3.5,19.6,689732,297358,392374,10.6,24.7,-142763,-5.1,39.2,0,33445,33681,213569,
1985,e) 4,236745,250353,2589976,2618798,9472,3.6,35778,13.6,484958,66771,418187,2.5,18.5,544340,238880,305460,9.1,20.8,-59382,-2.3,37,0,25600,25695,158031,
1985,f) 5,203056,213580,1935586,1954599,8528,3.8,28766,12.9,370362,50298,320064,2.6,18.9,410222,179352,230870,9.2,21,-39860,-2.1,37.8,0,20608,20726,128014,
1985,g) 6 to 10,566490,648313,6806791,6835210,27787,4.1,77096,11.5,1223625,224073,999552,3.3,17.9,1286995,554133,732862,8.1,18.8,-63370,-0.9,35.8,0,49760,50192,329530,
1985,l) Left Censored,1513627,2269068,58191143,58219753,90641,3.9,190901,8.2,7565930,1868771,5697159,3.2,13,7626941,2704098,4922843,4.6,13.1,-61011,-0.1,26,0,95550,96939,819272,
1986,a) 0,522269,527731,3144164,1572082,526191,199.4,0,0,3135216,3135216,0,199.4,199.4,0,0,0,0,0,3135216,199.4,0,0,,,,
1986,b) 1,405009,412698,3218654,3101523,9403,2,105136,22.7,1135920,292543,843377,9.4,36.6,879202,488623,390579,15.8,28.3,256718,8.3,56.6,0,75357,75433,365227,
1986,c) 2,346294,355193,2956048,3051367,14276,3.7,68425,17.8,683191,110915,572276,3.6,22.4,858386,443315,415071,14.5,28.1,-175195,-5.7,44.8,0,51371,51386,332897,
1986,d) 3,247655,258461,2423489,2495821,10998,4,46071,16.6,498229,90389,407840,3.6,20,634149,298988,335161,12,25.4,-135920,-5.4,40,0,34720,34736,220299,
1986,e) 4,225415,243033,2610976,2677110,9144,3.6,37094,14.4,465734,76268,389466,2.8,17.4,593658,255021,338637,9.5,22.2,-127924,-4.8,34.8,0,26687,26778,176649,
1986,f) 5,213290,227409,2530237,2573181,8421,3.5,30870,12.9,453181,70045,383136,2.7,17.6,536013,219944,316069,8.5,20.8,-82832,-3.2,35.2,0,22098,22162,151530,
1986,g) 6 to 10,707835,803334,8645486,8741339,35100,4.2,93580,11.2,1512413,300339,1212074,3.4,17.3,1697183,630267,1066916,7.2,19.4,-184770,-2.1,34.6,0,62281,62563,392235,
1986,l) Left Censored,1418093,2182603,57941496,57954912,98165,4.4,177859,8,7602266,2171372,5430894,3.7,13.1,7614330,2397315,5217015,4.1,13.1,-12064,0,26.2,0,91692,92737,763552,
1987,a) 0,544102,558508,3584809,1792405,554819,198.7,0,0,3279406,3279406,0,183,183,0,0,0,0,0,3279406,183,0,0,,,,
1987,b) 1,404614,417724,3612126,3648771,7545,1.6,105935,22.4,968940,119153,849787,3.3,26.6,1006690,535792,470898,14.7,27.6,-37750,-1,53.2,0,81457,81519,413873,
1987,c) 2,342090,355126,3005239,3105010,20202,5.3,70223,18.3,744360,160284,584076,5.2,24,918569,470690,447879,15.2,29.6,-174209,-5.6,48,0,54513,54613,336258,
1987,d) 3,303858,318307,2813164,2881589,16187,4.8,50013,14.9,621970,137129,484841,4.8,21.6,746123,351271,394852,12.2,25.9,-124153,-4.3,43.2,0,38634,38666,268238,
1987,e) 4,218754,235091,2328136,2384599,12764,5.2,35249,14.3,485852,125122,360730,5.2,20.4,590803,264411,326392,11.1,24.8,-104951,-4.4,40.8,0,26732,26934,189802,
1987,f) 5,201339,220586,2506785,2551015,9981,4.3,31097,13.4,458608,95753,362855,3.8,18,543435,223320,320115,8.8,21.3,-84827,-3.3,36,0,22323,22563,152475,
1987,g) 6 to 10,843497,959812,10901202,11075860,48287,4.8,116654,11.7,1934345,410983,1523362,3.7,17.5,2240856,898526,1342330,8.1,20.2,-306511,-2.7,35,0,75088,76299,540786,
1987,l) Left Censored,1321439,2100301,56901635,57444997,113194,5.3,196909,9.2,7434272,2111130,5323142,3.7,12.9,8399731,3002844,5396887,5.2,14.6,-965459,-1.7,25.8,0,90600,92848,803268,
1988,a) 0,489337,496560,3084643,1542322,491758,198.1,0,0,3055757,3055757,0,198.1,198.1,0,0,0,0,0,3055757,198.1,0,0,,,,
1988,b) 1,405794,420643,4071366,4106827,3694,0.8,129074,26.4,1031981,125539,906442,3.1,25.1,1062067,637409,424658,15.5,25.9,-30086,-0.8,50.2,0,102547,102550,484243,
1988,c) 2,337420,351681,2919807,3003877,13398,3.5,75008,19.5,685322,107450,577872,3.6,22.8,841111,436681,404430,14.5,28,-155789,-5.2,45.6,0,59965,59965,354834,
1988,d) 3,297463,311494,2844970,2913512,11741,3.5,53619,16.1,591989,105662,486327,3.6,20.3,730631,349839,380792,12,25.1,-138642,-4.8,40.6,0,42384,42384,279049,
1988,e) 4,270938,286241,2672154,2747210,10071,3.3,40920,13.5,504388,80626,423762,2.9,18.4,651065,274304,376761,10,23.7,-146677,-5.3,36.8,0,31125,31125,200866,
1988,f) 5,196397,213854,2252941,2275798,7999,3.6,28509,12.7,419606,74863,344743,3.3,18.4,464675,184546,280129,8.1,20.4,-45069,-2,36.8,0,21367,21367,131915,
1988,g) 6 to 10,813355,894733,10088995,10194767,33937,3.7,99638,10.7,1691926,335919,1356007,3.3,16.6,1898214,694783,1203431,6.8,18.6,-206288,-2,33.2,0,68743,68744,442253,
1988,h) 11 to 15,150135,209579,3134092,3093517,11148,5.2,19237,9,586336,158208,428128,5.1,19,510007,164051,345956,5.3,16.5,76329,2.5,33,0,9987,9990,57699,
1988,l) Left Censored,1236703,2036387,56345944,56183726,117344,5.7,166378,8.1,7978167,2275961,5702206,4.1,14.2,7530347,2509163,5021184,4.5,13.4,447820,0.8,26.8,0,72013,72025,475404,
1989,a) 0,473834,480285,2967874,1483937,477022,198.6,0,0,2954532,2954532,0,199.1,199.1,0,0,0,0,0,2954532,199.1,0,0,,,,
1989,b) 1,378885,388862,3214942,3191079,3329,0.8,106729,24.1,996813,93300,903513,2.9,31.2,939989,543817,396172,17,29.5,56824,1.7,59,0,79149,79220,429624,
1989,c) 2,339316,354864,3731702,3855397,13603,3.5,77876,20.1,726393,122275,604118,3.2,18.8,960894,556824,404070,14.4,24.9,-234501,-6.1,37.6,0,58829,58953,444842,
1989,d) 3,292683,307485,2829859,2873452,11496,3.5,55832,16.9,608600,83689,524911,2.9,21.2,699930,344481,355449,12,24.4,-91330,-3.2,42.4,0,41600,41695,259289,
1989,e) 4,263514,279077,2771046,2815635,10214,3.5,43507,14.7,516693,84730,431963,3,18.4,610805,280706,330099,10,21.7,-94112,-3.3,36.8,0,31616,31714,203634,
1989,f) 5,244111,259986,2582781,2619478,8883,3.3,35306,12.9,464036,83427,380609,3.2,17.7,537972,239364,298608,9.1,20.5,-73936,-2.8,35.4,0,24663,24775,166796,
1989,g) 6 to 10,790941,878963,10492085,10564574,32957,3.6,106039,11.6,1746215,317587,1428628,3,16.5,1920458,790468,1129990,7.5,18.2,-174243,-1.7,33,0,67074,67666,472783,
1989,h) 11 to 15,272311,349882,4860248,4874670,15383,4.3,34819,9.7,767991,168896,599095,3.5,15.8,802343,290753,511590,6,16.5,-34352,-0.7,31.6,0,19012,19384,136461,
1989,l) Left Censored,1156062,1980713,56969378,56604566,105670,5.3,163259,8.1,7800263,2345232,5455031,4.1,13.8,7236289,2238767,4997522,4,12.8,563974,1,25.6,0,70658,73156,612811,
1990,a) 0,480684,485242,2927742,1463871,483039,199.1,0,0,2919030,2919030,0,199.4,199.4,0,0,0,0,0,2919030,199.4,0,0,,,,
1990,b) 1,378017,386367,3062521,3020718,3257,0.8,86477,20,943369,96535,846834,3.2,31.2,828963,430088,398875,14.2,27.4,114406,3.8,54.8,0,68065,68107,352794,
1990,c) 2,323701,335073,2968202,3081864,15772,4.4,63052,17.4,656069,109568,546501,3.6,21.3,858059,427883,430176,13.9,27.8,-201990,-6.5,42.6,0,51268,51363,354736,
1990,d) 3,297227,313675,3582721,3653844,15233,4.6,52779,15.8,598643,106969,491674,2.9,16.4,722599,344284,378315,9.4,19.8,-123956,-3.4,32.8,0,42365,42472,277843,
1990,e) 4,261918,277304,2661106,2737470,12719,4.4,40342,13.8,509946,93024,416922,3.4,18.6,652143,279072,373071,10.2,23.8,-142197,-5.2,37.2,0,31919,32005,216056,
1990,f) 5,239388,255811,2673022,2715062,11471,4.3,33067,12.4,459737,92895,366842,3.4,16.9,536879,219199,317680,8.1,19.8,-77142,-2.9,33.8,0,25428,25495,169045,
1990,g) 6 to 10,836382,925548,11018558,11128435,43138,4.5,91641,9.6,1742558,399835,1342723,3.6,15.7,1947227,704218,1243009,6.3,17.5,-204669,-1.8,31.4,0,66289,66745,480906,
1990,h) 11 to 15,394767,492023,6684917,6693760,24846,5,40421,8.1,1039297,258830,780467,3.9,15.5,1038965,332153,706812,5,15.5,332,0,31,0,25703,26167,192290,
1990,l) Left Censored,1101969,1941183,57005586,56999703,97932,5,135197,6.9,6799933,1802599,4997334,3.2,11.9,6792697,1854740,4937957,3.3,11.9,7236,0,23.8,0,60309,61610,490999,
1991,a) 0,470456,477382,2734513,1367257,473456,198.4,0,0,2716819,2716819,0,198.7,198.7,0,0,0,0,0,2716819,198.7,0,0,,,,
1991,b) 1,386128,394546,2908687,2919345,4580,1,87969,20,881849,117974,763875,4,30.2,882941,426674,456267,14.6,30.2,-1092,0,60.4,0,61461,61517,320308,
1991,c) 2,324015,334384,2638174,2831914,11773,3.3,61627,17.1,537337,83425,453912,2.9,19,921821,435084,486737,15.4,32.6,-384484,-13.6,38,0,46290,46512,352331,
1991,d) 3,282333,295812,2681136,2824417,11387,3.6,49905,15.8,469497,88011,381486,3.1,16.6,763302,331534,431768,11.7,27,-293805,-10.4,33.2,0,37759,37875,267307,
1991,e) 4,262327,280065,3270669,3416083,10974,3.7,44845,15.1,440992,91044,349948,2.7,12.9,744386,341893,402493,10,21.8,-303394,-8.9,25.8,0,32924,33535,265978,
1991,f) 5,234105,251077,2426721,2545446,9483,3.6,35892,13.6,392604,85935,306669,3.4,15.4,631095,261045,370050,10.3,24.8,-238491,-9.4,30.8,0,26393,26564,201444,
1991,g) 6 to 10,867434,966075,11118316,11516645,37869,3.8,104302,10.4,1587187,385122,1202065,3.3,13.8,2388593,808891,1579702,7,20.7,-801406,-6.9,27.6,0,71363,72262,533699,
1991,h) 11 to 15,497529,615474,8063920,8240684,28449,4.5,54989,8.8,1126712,319311,807401,3.9,13.7,1482880,440288,1042592,5.3,18,-356168,-4.3,27.4,0,32890,33754,247237,
1991,l) Left Censored,1043414,1907439,55601096,56314034,106841,5.5,144602,7.5,6486569,2133433,4353136,3.8,11.5,7920566,2121607,5798959,3.8,14.1,-1433997,-2.6,23,0,58642,61549,586307,
1992,a) 0,464100,473595,2827110,1413555,472206,199.4,0,0,2814544,2814544,0,199.1,199.1,0,0,0,0,0,2814544,199.1,0,0,,,,
1992,b) 1,360718,371650,2685105,2693086,5031,1.2,98481,23.2,858803,114873,743930,4.3,31.9,845122,475922,369200,17.7,31.4,13681,0.5,62.8,0,76992,77039,388008,
1992,c) 2,322690,333452,2516595,2665952,15161,4.2,67775,18.7,570249,92091,478158,3.5,21.4,847620,456128,391492,17.1,31.8,-277371,-10.4,42.8,0,53884,54028,362474,
1992,d) 3,278929,291579,2435209,2515652,12835,4.1,50171,16.1,506444,83694,422750,3.3,20.1,652116,317106,335010,12.6,25.9,-145672,-5.8,40.2,0,39617,39864,258159,
1992,e) 4,247675,262753,2466983,2540243,11348,4.1,40408,14.5,476467,87765,388702,3.5,18.8,610851,279754,331097,11,24,-134384,-5.2,37.6,0,30857,31046,214368,
1992,f) 5,234294,252958,3148013,3184411,10850,4.1,35307,13.3,560045,102096,457949,3.2,17.6,631038,244305,386733,7.7,19.8,-70993,-2.2,35.2,0,25666,26179,181559,
1992,g) 6 to 10,881447,982479,10979316,11170641,41285,4.1,106181,10.4,1748687,342050,1406637,3.1,15.7,2092434,767456,1324978,6.9,18.7,-343747,-3,31.4,0,72306,73874,515521,
1992,h) 11 to 15,601923,747331,10063919,10203218,33540,4.4,66483,8.7,1504212,346794,1157418,3.4,14.7,1751094,565122,1185972,5.5,17.2,-246882,-2.5,29.4,0,38599,40387,324383,
1992,l) Left Censored,990711,1860523,54604664,55198187,92288,4.9,148789,7.9,6466172,1760309,4705863,3.2,11.7,7595729,2147979,5447750,3.9,13.8,-1129557,-2.1,23.4,0,53618,57907,468410,
1993,a) 0,475411,477669,2651353,1325677,473791,198.4,0,0,2636702,2636702,0,198.9,198.9,0,0,0,0,0,2636702,198.9,0,0,,,,
1993,b) 1,356575,367010,2923458,2885226,1864,0.4,99115,23.6,924535,116851,807684,4,32,821852,434366,387486,15.1,28.5,102683,3.5,57,0,79888,79919,363993,
1993,c) 2,308324,320043,2473382,2568820,11232,3.2,59779,17.3,573882,68527,505355,2.7,22.3,754653,383807,370846,14.9,29.4,-180771,-7.1,44.6,0,48387,48513,315308,
1993,d) 3,284135,294755,2402521,2447942,10840,3.5,46980,15,502744,62749,439995,2.6,20.5,587172,267073,320099,10.9,24,-84428,-3.5,41,0,37559,37650,216783,
1993,e) 4,250117,263043,2337392,2378785,9190,3.3,36744,13.3,438440,61503,376937,2.6,18.4,517678,222308,295370,9.3,21.8,-79238,-3.4,36.8,0,29144,29220,179159,
1993,f) 5,224704,239268,2375884,2412988,8233,3.3,30828,12.3,408757,66521,342236,2.8,16.9,480727,197588,283139,8.2,19.9,-71970,-3,33.8,0,23731,23873,151494,
1993,g) 6 to 10,913131,1008559,11708605,11844558,33144,3.2,98487,9.5,1700506,263805,1436701,2.2,14.4,1962540,661728,1300812,5.6,16.6,-262034,-2.2,28.8,0,71001,71689,449572,
1993,h) 11 to 15,586133,687488,8975097,9036795,21170,3,53985,7.7,1223785,201500,1022285,2.2,13.5,1351449,396190,955259,4.4,15,-127664,-1.5,27,0,35559,36247,232611,
1993,i) 16 to 20,113474,180191,3165908,3147381,6522,3.6,12756,7,453668,103223,350445,3.3,14.4,425610,118535,307075,3.8,13.5,28058,0.9,27,0,6007,6363,38414,
1993,l) Left Censored,941716,1792298,54285254,54430931,70775,3.9,136665,7.5,6472501,1529205,4943296,2.8,11.9,6796600,1997199,4799401,3.7,12.5,-324099,-0.6,23.8,0,47672,49718,361042,
1994,a) 0,497278,501382,2925610,1462805,497804,198.6,0,0,2914800,2914800,0,199.3,199.3,0,0,0,0,0,2914800,199.3,0,0,,,,
1994,b) 1,367123,371167,2682164,2680218,1967,0.5,99056,23.3,808055,54002,754053,2,30.1,775079,448756,326323,16.7,28.9,32976,1.2,57.8,0,79502,79516,375708,
1994,c) 2,301830,312866,2610362,2759332,10152,3,61021,18,552028,67714,484314,2.5,20,840074,408129,431945,14.8,30.4,-288046,-10.4,40,0,48982,49035,335204,
1994,d) 3,270334,282142,2305119,2382829,9495,3.2,45316,15.1,462768,58360,404408,2.4,19.4,612698,284619,328079,11.9,25.7,-149930,-6.3,38.8,0,35680,35727,227400,
1994,e) 4,253992,264988,2273313,2335078,9232,3.3,37803,13.5,423693,55396,368297,2.4,18.1,541176,241609,299567,10.3,23.2,-117483,-5.1,36.2,0,29180,29312,189523,
1994,f) 5,225840,239415,2231556,2277766,8411,3.3,31207,12.4,391296,61092,330204,2.7,17.2,481670,192133,289537,8.4,21.1,-90374,-3.9,34.4,0,24283,24358,146020,
1994,g) 6 to 10,931535,1023785,11919989,12046321,34704,3.3,103150,9.7,1736482,297350,1439132,2.5,14.4,1971290,722123,1249167,6,16.4,-234808,-2,28.8,0,74385,74918,496193,
1994,h) 11 to 15,577704,678627,9130365,9182104,21995,3.2,54703,7.9,1219161,235076,984085,2.6,13.3,1312731,406414,906317,4.4,14.3,-93570,-1,26.6,0,35313,35726,232345,
1994,i) 16 to 20,207716,294717,4743513,4732112,11506,3.8,21617,7.2,629415,136539,492876,2.9,13.3,602380,173652,428728,3.7,12.7,27035,0.6,25.4,0,11441,11827,78478,
1994,l) Left Censored,894534,1757823,54165134,54247603,83373,4.7,119422,6.7,6205523,1717875,4487648,3.2,11.4,6363729,1811753,4551976,3.3,11.7,-158206,-0.3,22.8,0,44833,46289,341710,
1995,a) 0,513073,517045,2976674,1488337,513352,198.6,0,0,2963741,2963741,0,199.1,199.1,0,0,0,0,0,2963741,199.1,0,0,,,,
1995,b) 1,383186,389587,2926465,2920682,2324,0.5,103843,23.3,859348,67554,791794,2.3,29.4,819690,463996,355694,15.9,28.1,39658,1.3,56.2,0,83875,83913,391034,
1995,c) 2,311391,316586,2552219,2595483,10560,3.1,61050,17.8,603864,73981,529883,2.9,23.3,678237,369594,308643,14.2,26.1,-74373,-2.8,46.6,0,50161,50197,317661,
1995,d) 3,264914,276363,2449239,2488424,9872,3.4,43950,14.9,490598,80705,409893,3.2,19.7,562167,272084,290083,10.9,22.6,-71569,-2.9,39.4,0,34894,35025,212976,
1995,e) 4,242312,254686,2259995,2284059,9082,3.4,34932,13,430913,60080,370833,2.6,18.9,473655,211079,262576,9.2,20.7,-42742,-1.8,37.8,0,27076,27199,160506,
1995,f) 5,229774,240690,2234440,2246150,8758,3.5,30693,12.2,409402,64831,344571,2.9,18.2,430485,184601,245884,8.2,19.2,-21083,-1,36.4,0,23575,23698,139697,
1995,g) 6 to 10,913776,1002178,11983331,11991575,35335,3.4,101508,9.8,1814717,345044,1469673,2.9,15.1,1822799,690173,1132626,5.8,15.2,-8082,-0.1,30.2,0,73581,74236,476540,
1995,h) 11 to 15,608499,711828,9719079,9675977,24595,3.4,54742,7.5,1376839,288942,1087897,3,14.2,1278703,410048,868655,4.2,13.2,98136,1,26.4,0,35558,35935,231523,
1995,i) 16 to 20,298041,405642,6598763,6536189,14649,3.5,29158,7.1,925225,211497,713728,3.2,14.2,796379,234287,562092,3.6,12.2,128846,2,24.4,0,16681,17179,108261,
1995,l) Left Censored,851928,1724931,54819378,54493998,84110,4.8,115766,6.6,6365568,1753782,4611786,3.2,11.7,5712082,1604335,4107747,2.9,10.5,653486,1.2,21,0,41618,42985,304845,
1996,a) 0,514974,519346,2994108,1497054,514889,198.3,0,0,2976453,2976453,0,198.8,198.8,0,0,0,0,0,2976453,198.8,0,0,,,,
1996,b) 1,396082,403063,2952298,2959245,3291,0.7,108003,23.5,872741,83101,789640,2.8,29.5,859919,476149,383770,16.1,29.1,12822,0.4,58.2,0,86616,86619,395961,
1996,c) 2,325539,332971,2696485,2791207,10873,3,64369,17.8,577011,77583,499428,2.8,20.7,755743,387561,368182,13.9,27.1,-178732,-6.4,41.4,0,52537,52540,330306,
1996,d) 3,273128,279481,2414347,2473935,9833,3.3,45475,15.3,486022,71874,414148,2.9,19.6,599762,296009,303753,12,24.2,-113740,-4.6,39.2,0,37008,37010,252634,
1996,e) 4,237099,248917,2311284,2371897,8660,3.3,35399,13.5,410981,78853,332128,3.3,17.3,532310,218031,314279,9.2,22.4,-121329,-5.1,34.6,0,27753,27756,172272,
1996,f) 5,220154,233231,2185331,2218908,8405,3.4,29492,12.1,376883,66207,310676,3,17,446489,184634,261855,8.3,20.1,-69606,-3.1,34,0,22772,22777,142389,
1996,g) 6 to 10,907872,989537,11651837,11793136,33810,3.3,103976,10.1,1666592,319037,1347555,2.7,14.1,1966694,720806,1245888,6.1,16.7,-300102,-2.6,28.2,0,75285,75300,492048,
1996,h) 11 to 15,633338,741612,10428770,10478926,24165,3.2,59674,7.9,1378580,288509,1090071,2.8,13.2,1508664,478415,1030249,4.6,14.4,-130084,-1.2,26.4,0,38295,38306,259045,
1996,i) 16 to 20,377133,502890,8069404,8083326,17388,3.4,37172,7.2,1033241,254314,778927,3.1,12.8,1075430,346216,729214,4.3,13.3,-42189,-0.5,25.6,0,21150,21169,131177,
1996,l) Left Censored,807682,1682773,54676062,54761214,81326,4.8,120168,7.1,6285861,1859216,4426645,3.4,11.5,6544983,1921245,4623738,3.5,12,-259122,-0.5,23,0,40248,40290,292196,
1997,a) 0,520056,527980,3052817,1526409,523890,198.5,0,0,3039903,3039903,0,199.2,199.2,0,0,0,0,0,3039903,199.2,0,0,,,,
1997,b) 1,394507,402739,2976317,2984443,3994,0.9,110683,24,912138,106267,805871,3.6,30.6,900135,523032,377103,17.5,30.2,12003,0.4,60.4,0,88477,88477,432534,
1997,c) 2,333943,343501,2676713,2769533,12520,3.4,68043,18.3,621729,85969,535760,3.1,22.4,795755,431729,364026,15.6,28.7,-174026,-6.3,44.8,0,54863,54863,362466,
1997,d) 3,283471,292693,2537074,2592974,10627,3.4,48948,15.7,530977,85652,445325,3.3,20.5,637388,321978,315410,12.4,24.6,-106411,-4.1,41,0,39069,39070,259367,
1997,e) 4,242329,251426,2256190,2320686,9499,3.6,36603,13.8,432331,73355,358976,3.2,18.6,554912,255072,299840,11,23.9,-122581,-5.3,37.2,0,29191,29192,202496,
1997,f) 5,213087,226121,2273067,2290730,8243,3.5,30201,12.7,426216,68984,357232,3,18.6,459596,200611,258985,8.8,20.1,-33380,-1.5,37.2,0,22926,22926,152107,
1997,g) 6 to 10,891684,973548,11362496,11459968,39007,3.9,107374,10.6,1882852,395787,1487065,3.5,16.4,2069457,794000,1275457,6.9,18.1,-186605,-1.7,32.8,0,75811,75811,502059,
1997,h) 11 to 15,644313,754787,10488970,10508860,31128,4,66461,8.6,1621203,384261,1236942,3.7,15.4,1652572,590672,1061900,5.6,15.7,-31369,-0.3,30.8,0,40286,40288,290830,
1997,i) 16 to 20,460189,612595,10266464,10236816,29687,4.8,51112,8.2,1552376,452380,1099996,4.4,15.2,1488169,453275,1034894,4.4,14.5,64207,0.7,29,0,25318,25318,176466,
1997,l) Left Censored,770308,1657825,55313656,55184938,105669,6.3,143623,8.6,7504557,2182295,5322262,4,13.6,7238995,2425493,4813502,4.4,13.1,265562,0.5,26.2,0,37761,37763,313906,
1998,a) 0,515145,519954,3428443,1714222,516165,198.5,0,0,3415412,3415412,0,199.2,199.2,0,0,0,0,0,3415412,199.2,0,0,,,,
1998,b) 1,396961,405613,3053932,3054507,1488,0.3,114884,24.6,897305,59567,837738,2,29.4,872464,511721,360743,16.8,28.6,24841,0.8,57.2,0,91821,91821,420822,
1998,c) 2,332982,341725,2757000,2848147,10568,2.8,68720,18.5,611204,82873,528331,2.9,21.5,783795,417332,366463,14.7,27.5,-172591,-6,43,0,55697,55697,348005,
1998,d) 3,291378,301156,2515644,2582815,10212,3.2,50549,15.7,499939,68236,431703,2.6,19.4,628529,304227,324302,11.8,24.3,-128590,-4.9,38.8,0,40159,40159,246563,
1998,e) 4,251935,261030,2403235,2459013,8134,2.9,38597,14,449368,59861,389507,2.4,18.3,553232,246616,306616,10,22.5,-103864,-4.2,36.6,0,30531,30531,198039,
1998,f) 5,218101,227793,2162945,2206057,7144,3,30395,12.7,392925,57852,335073,2.6,17.8,475837,210290,265547,9.5,21.6,-82912,-3.8,35.6,0,23885,23885,161756,
1998,g) 6 to 10,870631,942447,10575367,10687311,29552,3,101677,10.4,1691400,284754,1406646,2.7,15.8,1904933,747071,1157862,7,17.8,-213533,-2,31.6,0,74424,74424,502788,
1998,h) 11 to 15,660354,768924,11134291,11166831,24977,3.2,63679,8.1,1512922,316302,1196620,2.8,13.5,1569178,540100,1029078,4.8,14.1,-56256,-0.6,27,0,41503,41503,283687,
1998,i) 16 to 20,443188,548733,8893236,8902362,16412,2.9,41325,7.4,1207405,243326,964079,2.7,13.6,1221820,413639,808181,4.6,13.7,-14415,-0.1,27.2,0,24834,24854,182108,
1998,j) 21 to 25,87137,164261,3688807,3654144,7716,4.6,11973,7.2,551449,149840,401609,4.1,15.1,480386,157520,322866,4.3,13.1,71063,2,26.2,0,4473,4473,30298,
1998,l) Left Censored,729431,1627522,55662832,55451603,93899,5.7,122135,7.4,6794484,1906502,4887982,3.4,12.3,6364428,1975777,4388651,3.6,11.5,430056,0.8,23,0,35747,35747,299056,
1999,a) 0,496788,501450,3211145,1605573,497596,198.5,0,0,3197430,3197430,0,199.1,199.1,0,0,0,0,0,3197430,199.1,0,0,,,,
1999,b) 1,399992,412647,3461984,3446333,7821,1.7,107625,23.1,1033006,226666,806340,6.6,30,976575,507157,469418,14.7,28.3,56431,1.7,56.6,0,84182,84182,409385,
1999,c) 2,335591,344635,2828106,2913695,10158,2.7,69339,18.5,640307,77022,563285,2.6,22,804348,456388,347960,15.7,27.6,-164041,-5.6,44,0,54455,54455,355900,
1999,d) 3,290118,298451,2581202,2652743,9314,2.9,51426,16.1,489295,63535,425760,2.4,18.4,620572,317517,303055,12,23.4,-131277,-5,36.8,0,40083,40083,245198,
1999,e) 4,259147,269567,2434484,2473059,9001,3.2,40236,14.1,459739,68986,390753,2.8,18.6,532789,253075,279714,10.2,21.5,-73050,-2.9,37.2,0,30873,30873,197301,
1999,f) 5,226716,236320,2324757,2357808,7816,3.1,32073,12.9,424918,75949,348969,3.2,18,487819,224212,263607,9.5,20.7,-62901,-2.7,36,0,24587,24587,165653,
1999,g) 6 to 10,861802,928685,10178742,10319346,28180,2.9,101594,10.5,1586946,267905,1319041,2.6,15.4,1861390,762359,1099031,7.4,18,-274444,-2.6,30.8,0,74085,74085,506442,
1999,h) 11 to 15,669483,778859,11577746,11632352,25850,3.2,65648,8.2,1565553,343269,1222284,3,13.5,1667426,582491,1084935,5,14.3,-101873,-0.8,27,0,42722,42722,301271,
1999,i) 16 to 20,435134,541512,9146247,9146964,16804,3,40912,7.4,1214935,294268,920667,3.2,13.3,1210113,395366,814747,4.3,13.2,4822,0.1,26.4,0,24481,24481,172585,
1999,j) 21 to 25,158045,257213,5297689,5301591,10493,4,18634,7.1,710352,192546,517806,3.6,13.4,718201,228991,489210,4.3,13.5,-7849,-0.1,26.8,0,8394,8394,56956,
1999,l) Left Censored,692545,1605282,56023469,56016787,92718,5.7,115832,7.2,6784295,2004031,4780264,3.6,12.1,6791878,2174375,4617503,3.9,12.1,-7583,0,24.2,0,33780,33780,281644,
2000,a) 0,481985,486975,3101975,1550988,483039,198.4,0,0,3088768,3088768,0,199.1,199.1,0,0,0,0,0,3088768,199.1,0,0,,,,
2000,b) 1,384859,394822,3389246,3306007,5362,1.2,106919,23.9,1068302,157230,911072,4.8,32.3,886248,484107,402141,14.6,26.8,182054,5.5,53.6,0,80070,80070,380373,
2000,c) 2,340577,358522,3426701,3413198,15847,4.1,67945,17.7,863404,223735,639669,6.6,25.3,833029,394577,438452,11.6,24.4,30375,0.9,48.8,0,51805,51805,313636,
2000,d) 3,293016,302575,2741003,2772672,10023,3.1,52043,16.1,560007,81712,478295,2.9,20.2,623192,328143,295049,11.8,22.5,-63185,-2.3,40.4,0,39068,39068,252528,
2000,e) 4,257966,266244,2527225,2546204,8007,2.8,40418,14.3,469082,56606,412476,2.2,18.4,508826,247016,261810,9.7,20,-39744,-1.6,36.8,0,29867,29867,181947,
2000,f) 5,232930,243369,2402693,2413532,7687,3,34104,13.3,451175,51823,399352,2.1,18.7,476417,219506,256911,9.1,19.7,-25242,-1,37.4,0,24658,24658,156444,
2000,g) 6 to 10,860126,920379,10360585,10409860,26162,2.7,104290,10.9,1712160,279391,1432769,2.7,16.4,1814435,767231,1047204,7.4,17.4,-102275,-1,32.8,0,73027,73027,507234,
2000,h) 11 to 15,645210,748893,11535055,11528229,24956,3.2,66834,8.7,1630138,365247,1264891,3.2,14.1,1623709,595796,1027913,5.2,14.1,6429,0,28.2,0,41888,41888,288447,
2000,i) 16 to 20,458866,567325,9369456,9389346,16612,2.9,43081,7.4,1244650,286716,957934,3.1,13.3,1274845,465796,809049,5,13.6,-30195,-0.3,26.6,0,24636,24636,182844,
2000,j) 21 to 25,225682,347785,7225335,7167088,13776,3.9,25261,7.1,1001027,289776,711251,4,14,887095,276812,610283,3.9,12.4,113932,1.6,24.8,0,11896,11896,77285,
2000,l) Left Censored,656127,1582788,56553074,56330283,95218,6,121831,7.6,7225156,2202195,5022961,3.9,12.8,6796747,2290124,4506623,4.1,12.1,428409,0.7,24.2,0,31032,31045,264678,
2001,a) 0,471220,476975,2974232,1487116,472876,198.3,0,0,2951512,2951512,0,198.5,198.5,0,0,0,0,0,2951512,198.5,0,0,,,,
2001,b) 1,374698,383652,3145072,3122707,4474,1,107758,24.8,946623,140797,805826,4.5,30.3,903422,485504,417918,15.5,28.9,43201,1.4,57.8,0,76428,76517,368183,
2001,c) 2,327207,340583,3177429,3254984,13499,3.7,69278,18.9,724002,153971,570031,4.7,22.2,890803,435095,455708,13.4,27.4,-166801,-5.2,44.4,0,50453,50456,330190,
2001,d) 3,298581,321483,3278821,3330020,15644,4.6,53588,15.8,683817,212575,471242,6.4,20.5,800702,339739,460963,10.2,24,-116885,-3.5,41,0,38864,38864,256339,
2001,e) 4,260517,270487,2551868,2638839,8719,3,43250,15.1,440564,62707,377857,2.4,16.7,634120,283593,350527,10.7,24,-193556,-7.3,33.4,0,30635,30642,194473,
2001,f) 5,231781,240454,2427596,2486654,7574,3,35644,14.1,407202,59898,347304,2.4,16.4,542085,235379,306706,9.5,21.8,-134883,-5.4,32.8,0,25194,25195,161667,
2001,g) 6 to 10,863020,921439,10255009,10481810,27899,2.9,112191,11.7,1517950,307633,1210317,2.9,14.5,2019505,808274,1211231,7.7,19.3,-501555,-4.8,29,0,73793,73795,503442,
2001,h) 11 to 15,634801,728354,10896697,11052717,22668,3,70538,9.4,1369639,302488,1067151,2.7,12.4,1729004,604237,1124767,5.5,15.6,-359365,-3.2,24.8,0,42015,42016,287484,
2001,i) 16 to 20,475692,598701,10255789,10294502,24995,4.1,47715,7.8,1340036,395784,944252,3.8,13,1457135,475410,981725,4.6,14.2,-117099,-1.2,26,0,24960,25015,176279,
2001,j) 21 to 25,285556,426434,8554427,8595615,17459,4,32187,7.4,1070376,310228,760148,3.6,12.5,1167887,376115,791772,4.4,13.6,-97511,-1.1,25,0,14884,14960,93559,
2001,l) Left Censored,699166,1640748,56832558,57010512,113831,6.9,119633,7.3,7001395,2177942,4823453,3.8,12.3,7484480,2162980,5321500,3.8,13.1,-483085,-0.8,24.6,0,28520,28642,241277,
2002,a) 0,503313,510836,3328143,1664072,510831,200,0,0,3314814,3314814,0,199.2,199.2,0,0,0,0,0,3314814,199.2,0,0,,,,
2002,b) 1,370952,378734,2770007,2851327,3044,0.7,112708,26,746539,57478,689061,2,26.2,903837,481072,422765,16.9,31.7,-157298,-5.5,52.4,0,78435,78515,367272,
2002,c) 2,322439,332808,2768682,2899970,16072,4.5,69536,19.3,588383,120396,467987,4.2,20.3,845491,396728,448763,13.7,29.2,-257108,-8.9,40.6,0,49624,49749,315265,
2002,d) 3,289346,304173,2800772,2911939,16290,5.1,52527,16.3,552351,136797,415554,4.7,19,770539,324918,445621,11.2,26.5,-218188,-7.5,38,0,37114,37197,251072,
2002,e) 4,266103,292472,2907110,2976682,17093,5.6,42948,14.1,571667,165022,406645,5.5,19.2,713731,256409,457322,8.6,24,-142064,-4.8,38.4,0,29939,29960,192951,
2002,f) 5,236377,245886,2325241,2441210,11235,4.3,36894,14.3,399462,81440,318022,3.3,16.4,624265,242484,381781,9.9,25.6,-224803,-9.2,32.8,0,24579,24639,168694,
2002,g) 6 to 10,885207,936356,10010546,10412823,42672,4.4,117488,12.1,1573804,366067,1207737,3.5,15.1,2343577,905246,1438331,8.7,22.5,-769773,-7.4,30.2,0,72982,73090,503109,
2002,h) 11 to 15,641078,728461,10269604,10556664,33822,4.5,74812,10,1449745,361268,1088477,3.4,13.7,2008568,718292,1290276,6.8,19,-558823,-5.3,27.4,0,40053,40145,300167,
2002,i) 16 to 20,486985,606903,9901830,10148090,29827,4.8,59953,9.6,1414670,461622,953048,4.5,13.9,1943968,702303,1241665,6.9,19.2,-529298,-5.3,27.8,0,25064,25292,191079,
2002,j) 21 to 25,349035,509824,10097729,10316706,26495,5.1,47475,9.1,1362761,428438,934323,4.2,13.2,1788122,616296,1171826,6,17.3,-425361,-4.1,26.4,0,17334,17487,135965,
2002,l) Left Censored,604337,1552731,54940565,55861172,109787,7,143471,9.1,7132935,2548121,4584814,4.6,12.8,8932816,2803342,6129474,5,16,-1799881,-3.2,25.6,0,25861,26191,277774,
2003,a) 0,506902,510518,3163641,1581821,510518,200,0,0,3163641,3163641,0,200,200,0,0,0,0,0,3163641,200,0,0,,,,
2003,b) 1,380394,388989,3046086,3180030,1591,0.4,112229,24.9,760618,28573,732045,0.9,23.9,991217,601608,389609,18.9,31.2,-230599,-7.3,47.8,0,87106,87165,510480,
2003,c) 2,319116,328238,2649132,2703474,16685,4.7,60381,17.1,577753,81008,496745,3,21.4,664659,337379,327280,12.5,24.6,-86906,-3.2,42.8,0,47727,47731,282820,
2003,d) 3,284252,295549,2643031,2697730,14424,4.6,46801,14.9,541340,80218,461122,3,20.1,626382,269728,356654,10,23.2,-85042,-3.1,40.2,0,36454,36471,222319,
2003,e) 4,259800,275399,2699223,2749509,13285,4.6,37761,13,501269,76372,424897,2.8,18.2,585978,255797,330181,9.3,21.3,-84709,-3.1,36.4,0,28962,29010,205531,
2003,f) 5,241523,269948,2848669,2877785,12914,4.6,32092,11.4,524962,104308,420654,3.6,18.2,569071,211956,357115,7.4,19.8,-44109,-1.6,36.4,0,24334,24339,166963,
2003,g) 6 to 10,904098,949318,10145092,10283240,41604,4.2,101346,10.3,1700970,317000,1383970,3.1,16.5,1926872,668446,1258426,6.5,18.7,-225902,-2.2,33,0,75295,75381,507381,
2003,h) 11 to 15,629060,707172,9301131,9355050,29140,4,59770,8.2,1401900,265997,1135903,2.8,15,1480179,474520,1005659,5.1,15.8,-78279,-0.8,30,0,40301,40409,289157,
2003,i) 16 to 20,500476,613206,10408523,10419088,23091,3.7,40263,6.5,1327084,292608,1034476,2.8,12.7,1327205,370610,956595,3.6,12.7,-121,0,25.4,0,26258,26753,201979,
2003,j) 21 to 25,339355,450187,8375548,8365016,15876,3.5,26482,5.8,1035631,259578,776053,3.1,12.4,1000744,245807,754937,2.9,12,34887,0.4,24,0,16957,17134,126806,
2003,k) 26+,66021,145790,3620138,3625574,7471,5.1,7533,5.2,478289,110871,367418,3.1,13.2,483729,101824,381905,2.8,13.3,-5440,-0.1,26.4,0,2885,3014,21430,
2003,l) Left Censored,577323,1526105,53816651,54061599,93790,6.2,84282,5.5,6254022,1957250,4296772,3.6,11.6,6497836,1640598,4857238,3,12,-243814,-0.4,23.2,0,24205,25131,240181,
2004,a) 0,526598,529329,3162070,1581035,526860,199.1,0,0,3152396,3152396,0,199.4,199.4,0,0,0,0,0,3152396,199.4,0,0,,,,
2004,b) 1,383491,388247,2941944,3052627,1155,0.3,112589,25.1,776740,17753,758987,0.6,25.4,960191,563586,396605,18.5,31.5,-183451,-6.1,50.8,0,88095,88105,482223,
2004,c) 2,326877,335990,2911680,2973667,13227,3.7,62625,17.3,594763,71831,522932,2.4,20,705035,362552,342483,12.2,23.7,-110272,-3.7,40,0,49564,49583,307319,
2004,d) 3,282687,292703,2535619,2585060,12081,3.9,45278,14.6,481279,61506,419773,2.4,18.6,568493,276352,292141,10.7,22,-87214,-3.4,37.2,0,35276,35308,234914,
2004,e) 4,255730,267161,2562237,2593151,11071,3.9,36948,13.1,454125,64750,389375,2.5,17.5,504908,220895,284013,8.5,19.5,-50783,-2,35,0,28172,28220,169081,
2004,f) 5,235727,251278,2592979,2632834,9902,3.8,31655,12,418190,58204,359986,2.2,15.9,489312,211557,277755,8,18.6,-71122,-2.7,31.8,0,23915,23995,168651,
2004,g) 6 to 10,925435,990708,10894377,11021895,39127,3.8,102736,10,1648763,267848,1380915,2.4,15,1871195,678509,1192686,6.2,17,-222432,-2,30,0,76037,76209,517253,
2004,h) 11 to 15,627234,696579,8883521,8949995,25237,3.5,59274,8.3,1249743,235735,1014008,2.6,14,1358558,467166,891392,5.2,15.2,-108815,-1.2,28,0,40137,40230,287092,
2004,i) 16 to 20,509254,621286,10560159,10662884,21053,3.3,41050,6.5,1218792,258930,959862,2.4,11.4,1410999,430857,980142,4,13.2,-192207,-1.8,22.8,0,26672,26998,188701,
2004,j) 21 to 25,336352,450233,8503284,8526456,17629,3.9,27669,6.1,999326,228481,770845,2.7,11.7,1036137,286175,749962,3.4,12.2,-36811,-0.5,23.4,0,16320,16504,120056,
2004,k) 26+,121585,222766,5110858,5105281,8421,3.8,11062,4.9,606446,175354,431092,3.4,11.9,591829,143034,448795,2.8,11.6,14617,0.3,23.2,0,5711,5844,55691,
2004,l) Left Censored,553144,1495906,53339147,53307875,84356,5.6,94039,6.3,6138786,1737586,4401200,3.3,11.5,6042383,1765916,4276467,3.3,11.3,96403,0.2,22.6,0,22453,22870,225273,
2005,a) 0,549264,555629,3412890,1706445,551941,198.7,0,0,3396777,3396777,0,199.1,199.1,0,0,0,0,0,3396777,199.1,0,0,,,,
2005,b) 1,401017,405012,2926647,3028295,1431,0.3,114603,24.5,781161,18073,763088,0.6,25.8,944604,546708,397896,18.1,31.2,-163443,-5.4,51.6,0,90076,90084,467836,
2005,c) 2,329961,335526,2686543,2786205,13687,3.8,63430,17.5,557644,67555,490089,2.4,20,742727,387251,355476,13.9,26.7,-185083,-6.7,40,0,51487,51534,340885,
2005,d) 3,290625,300335,2728533,2808195,11911,3.7,46021,14.5,471790,62454,409336,2.2,16.8,627164,289832,337332,10.3,22.3,-155374,-5.5,33.6,0,36790,36803,243973,
2005,e) 4,255759,266478,2413336,2462827,11216,4,35781,12.8,426272,61614,364658,2.5,17.3,510627,215805,294822,8.8,20.7,-84355,-3.4,34.6,0,28006,28061,177667,
2005,f) 5,233481,245192,2445262,2496740,9806,3.8,30278,11.8,387344,58217,329127,2.3,15.5,484593,192344,292249,7.7,19.4,-97249,-3.9,31,0,23228,23284,158729,
2005,g) 6 to 10,936227,1011224,11137600,11323538,40875,3.9,103528,9.9,1714889,331596,1383293,2.9,15.1,2062978,756691,1306287,6.7,18.2,-348089,-3.1,30.2,0,77724,77923,586598,
2005,h) 11 to 15,632009,694579,8740847,8819865,26775,3.8,58051,8.2,1235896,260747,975149,3,14,1394689,423787,970902,4.8,15.8,-158793,-1.8,28,0,41473,41559,294240,
2005,i) 16 to 20,489601,597314,10124949,10208450,22064,3.6,41180,6.8,1153672,270924,882748,2.7,11.3,1312610,378706,933904,3.7,12.9,-158938,-1.6,22.6,0,27295,27550,218086,
2005,j) 21 to 25,362014,482999,8723651,8799203,16138,3.3,28084,5.7,958179,211967,746212,2.4,10.9,1101708,295492,806216,3.4,12.5,-143529,-1.6,21.8,0,17286,17414,167618,
2005,k) 26+,175367,304314,6886846,6839789,13179,4.3,16069,5.3,873599,273735,599864,4,12.8,777833,175394,602439,2.6,11.4,95766,1.4,22.8,0,8497,8675,68599,
2005,l) Left Censored,530314,1480907,53289283,53201645,92424,6.3,84145,5.7,5923857,1966439,3957418,3.7,11.1,5753458,1524605,4228853,2.9,10.8,170399,0.3,21.6,0,22304,22723,277139,
2006,a) 0,561873,573883,3553163,1776582,568829,198.2,0,0,3535589,3535589,0,199,199,0,0,0,0,0,3535589,199,0,0,,,,
2006,b) 1,412135,420739,3235870,3317044,2465,0.5,125306,25.7,853429,33443,819986,1,25.7,979984,581662,398322,17.5,29.5,-126555,-3.8,51.4,0,97680,97719,488949,
2006,c) 2,340162,345485,2754000,2815131,13003,3.5,69692,18.6,582579,69913,512666,2.5,20.7,696393,377423,318970,13.4,24.7,-113814,-4,41.4,0,54877,54913,320242,
2006,d) 3,287173,293917,2593209,2625313,10973,3.5,51076,16.2,513092,60708,452384,2.3,19.5,572013,286051,285962,10.9,21.8,-58921,-2.3,39,0,39745,39769,239890,
2006,e) 4,258571,269451,2670756,2695664,10172,3.6,39791,14,462849,63560,399289,2.4,17.2,510778,236461,274317,8.8,18.9,-47929,-1.7,34.4,0,30274,30314,192424,
2006,f) 5,230217,241648,2360181,2370835,8933,3.5,32517,12.8,407481,52706,354775,2.2,17.2,425945,189583,236362,8,18,-18464,-0.8,34.4,0,24355,24427,154908,
2006,g) 6 to 10,927764,1009279,11460059,11530137,38224,3.6,113110,10.8,1777806,299192,1478614,2.6,15.4,1902690,760303,1142387,6.6,16.5,-124884,-1.1,30.8,0,80933,81069,577757,
2006,h) 11 to 15,622367,684809,8736563,8759341,24928,3.5,64705,9.2,1285709,251933,1033776,2.9,14.7,1325577,501986,823591,5.7,15.1,-39868,-0.4,29.4,0,44769,44920,360838,
2006,i) 16 to 20,487064,590092,10023750,9995531,24679,4.1,46466,7.7,1283713,326374,957339,3.3,12.8,1220668,386042,834626,3.9,12.2,63045,0.6,24.4,0,30381,30486,244734,
2006,j) 21 to 25,373539,507491,9480963,9455958,20664,4,33089,6.4,1123070,312306,810764,3.3,11.9,1068552,308496,760056,3.3,11.3,54518,0.6,22.6,0,19380,19531,165814,
2006,k) 26+,221375,371323,8287160,8193295,17687,4.7,23244,6.2,1094695,389335,705360,4.8,13.4,906052,265436,640616,3.2,11.1,188643,2.3,22.2,0,11848,11975,103057,
2006,l) Left Censored,502633,1473550,53759558,53421765,91120,6.2,80151,5.5,6217469,1851254,4366215,3.5,11.6,5522603,1460212,4062391,2.7,10.3,694866,1.3,20.6,0,23282,23903,323550,
2007,a) 0,529224,533032,3067338,1533669,518935,194.7,0,0,3023136,3023136,0,197.1,197.1,0,0,0,0,0,3023136,197.1,0,0,,,,
2007,b) 1,422614,436835,3242049,3384961,3079,0.6,128272,25.4,825052,49196,775856,1.5,24.4,1078050,586890,491160,17.3,31.8,-252998,-7.4,48.8,0,98898,99047,476590,
2007,c) 2,355823,366430,2957720,3068560,14453,3.7,70038,17.8,608504,91869,516635,3,19.8,829645,389426,440219,12.7,27,-221141,-7.2,39.6,0,55168,55285,314867,
2007,d) 3,302123,310108,2590429,2655878,12145,3.7,51261,15.6,491172,78804,412368,3,18.5,630012,298804,331208,11.3,23.7,-138840,-5.2,37,0,39994,40051,237347,
2007,e) 4,260368,274577,2563405,2591317,11368,4,39176,13.6,507296,91499,415797,3.5,19.6,567929,245459,322470,9.5,21.9,-60633,-2.3,39.2,0,29792,29832,178550,
2007,f) 5,235575,245695,2490792,2545629,9373,3.7,32440,12.7,402853,68487,334366,2.7,15.8,515556,212465,303091,8.3,20.3,-112703,-4.5,31.6,0,23619,23749,146216,
2007,g) 6 to 10,927110,1003740,11261296,11464765,40497,3.9,112552,10.8,1721752,348082,1373670,3,15,2146405,808949,1337456,7.1,18.7,-424653,-3.7,30,0,75553,76551,520081,
2007,h) 11 to 15,628729,686615,8551738,8717201,25945,3.7,63360,9,1165397,250186,915211,2.9,13.4,1499643,483830,1015813,5.6,17.2,-334246,-3.8,26.8,0,42136,42628,290673,
2007,i) 16 to 20,482340,583690,9696321,9737615,25237,4.2,47168,7.9,1311238,284881,1026357,2.9,13.5,1398497,403581,994916,4.1,14.4,-87259,-0.9,27,0,27829,28313,200983,
2007,j) 21 to 25,381805,517075,9562986,9608502,24890,4.8,38648,7.4,1276161,342739,933422,3.6,13.3,1367903,393754,974149,4.1,14.2,-91742,-0.9,26.6,0,18506,19099,141090,
2007,k) 26+,273622,452539,10207088,10173712,24480,5.4,30856,6.8,1361846,371747,990099,3.7,13.4,1302252,326832,975420,3.2,12.8,59594,0.6,25.6,0,13596,14264,102158,
2007,l) Left Censored,486078,1477719,53721000,53706455,108973,7.4,99817,6.8,6733545,2020005,4713540,3.8,12.5,6723884,1848618,4875266,3.4,12.5,9661,0,25,0,20201,21845,228377,
2008,a) 0,491292,496328,2859065,1429533,483067,194.7,0,0,2805401,2805401,0,196.2,196.2,0,0,0,0,0,2805401,196.2,0,0,,,,
2008,b) 1,387915,392328,2729524,2885482,761,0.2,131981,28.5,690772,22176,668596,0.8,23.9,976819,567115,409704,19.7,33.9,-286047,-10,47.8,0,102189,102189,481333,
2008,c) 2,355412,370315,2921394,3064450,12638,3.1,79942,19.8,532799,75003,457796,2.4,17.4,824441,409665,414776,13.4,26.9,-291642,-9.5,34.8,0,61910,61929,338828,
2008,d) 3,308248,319228,2731152,2829415,10448,3.1,58614,17.1,473563,79239,394324,2.8,16.7,674118,315861,358257,11.2,23.8,-200555,-7.1,33.4,0,46496,46515,270125,
2008,e) 4,265987,274662,2425239,2496918,8759,3,45392,15.5,387202,47010,340192,1.9,15.5,535646,245550,290096,9.8,21.5,-148444,-6,31,0,35613,35638,207810,
2008,f) 5,232830,248095,2397709,2472735,8251,3.2,35530,13.6,362203,55073,307130,2.2,14.6,517359,223222,294137,9,20.9,-155156,-6.3,29.2,0,27525,27533,191953,
2008,g) 6 to 10,920886,996044,11289491,11512388,30826,3,113269,10.9,1544693,252322,1292371,2.2,13.4,2007505,752452,1255053,6.5,17.4,-462812,-4,26.8,0,83240,83431,578962,
2008,h) 11 to 15,638527,690388,8556125,8686281,20993,3,64384,9.1,1103630,240061,863569,2.8,12.7,1370534,430174,940360,5,15.8,-266904,-3.1,25.4,0,45132,45213,309131,
2008,i) 16 to 20,470100,558666,8586366,8671991,18164,3.2,44559,7.8,1076345,215290,861055,2.5,12.4,1248232,371878,876354,4.3,14.4,-171887,-2,24.8,0,28543,28588,203466,
2008,j) 21 to 25,390267,518855,9998508,10021482,16888,3.2,32090,6.1,1116223,267370,848853,2.7,11.1,1165970,295415,870555,2.9,11.6,-49747,-0.5,22.2,0,20140,20293,155226,
2008,k) 26+,316698,529215,12148908,12144147,21201,4,29813,5.6,1463612,363129,1100483,3,12.1,1457823,332212,1125611,2.7,12,5789,0.1,24,0,16165,16293,126844,
2008,l) Left Censored,464862,1467809,53438074,53383002,80840,5.5,69221,4.7,5862282,1719210,4143072,3.2,11,5777258,1205284,4571974,2.3,10.8,85024,0.2,21.6,0,18967,19247,228593,
2009,a) 0,410038,413734,2417209,1208605,404650,195.6,0,0,2385585,2385585,0,197.4,197.4,0,0,0,0,0,2385585,197.4,0,0,3,3,0,
2009,b) 1,354196,359399,2382452,2620168,452,0.1,137230,32.1,553960,11212,542748,0.4,21.1,1029391,562821,466570,21.5,39.3,-475431,-18.2,42.2,0,99221,99292,452986,
2009,c) 2,317768,322191,2348555,2532394,10407,2.9,86261,24.2,405989,59909,346080,2.4,16,793618,396043,397575,15.6,31.3,-387629,-15.3,32,0,63481,63493,318832,
2009,d) 3,300841,315387,2529886,2712119,10217,3,68971,20.1,366505,46265,320240,1.7,13.5,745517,318771,426746,11.8,27.5,-379012,-14,27,0,50327,50426,251473,
2009,e) 4,265813,276575,2400772,2559870,8301,2.8,53984,18.1,337625,59822,277803,2.3,13.2,670020,271094,398926,10.6,26.2,-332395,-13,26.4,0,39194,39223,203400,
2009,f) 5,232559,241050,2141443,2277324,6806,2.6,43054,16.7,282743,31523,251220,1.4,12.4,567415,220441,346974,9.7,24.9,-284672,-12.5,24.8,0,30677,30716,172722,
2009,g) 6 to 10,893933,956547,10087717,10639797,26633,2.7,132134,13.2,1134847,189592,945255,1.8,10.7,2279029,782459,1496570,7.4,21.4,-1144182,-10.7,21.4,0,89034,89350,562715,
2009,h) 11 to 15,641736,709884,8550318,8970550,19816,2.7,76473,10.4,884350,177995,706355,2,9.9,1752195,473517,1278678,5.3,19.5,-867845,-9.6,19.8,0,49009,49242,316904,
2009,i) 16 to 20,461553,542398,7573115,7899276,16160,2.9,49684,8.9,773184,172209,600975,2.2,9.8,1446168,341655,1104513,4.3,18.3,-672984,-8.5,19.6,0,29991,30090,194655,
2009,j) 21 to 25,391239,512176,9606353,9922250,14310,2.7,36834,7.1,855290,239268,616022,2.4,8.6,1499029,325828,1173201,3.3,15.1,-643739,-6.5,17.2,0,21445,21527,159458,
2009,k) 26+,355247,595693,13026513,13411656,21017,3.5,37821,6.3,1216633,364099,852534,2.7,9.1,2001769,399613,1602156,3,14.9,-785136,-5.8,18.2,0,18325,18889,130951,
2009,l) Left Censored,445624,1432024,50599336,51757174,70534,4.9,83231,5.8,4347304,1315211,3032093,2.5,8.4,6691688,1371742,5319946,2.7,12.9,-2344384,-4.5,16.8,0,17961,18854,202852,
2010,a) 0,389701,396231,2435999,1218000,396231,200,0,0,2435999,2435999,0,200,200,0,0,0,0,0,2435999,200,0,0,,,,
2010,b) 1,304416,308689,2128677,2268626,825,0.2,105726,29.3,494065,13856,480209,0.6,21.8,773963,448203,325760,19.8,34.1,-279898,-12.3,43.6,0,77402,77451,367879,
2010,c) 2,300675,305843,2161940,2264143,17773,5.3,71125,21.4,422566,74458,348108,3.3,18.7,626971,335767,291204,14.8,27.7,-204405,-9,37.4,0,53346,53374,273886,
2010,d) 3,276834,281185,2116691,2225283,15873,5.3,56767,18.8,347280,61792,285488,2.8,15.6,564464,273128,291336,12.3,25.4,-217184,-9.8,31.2,0,41840,41860,226603,
2010,e) 4,266967,281699,2323268,2421732,15290,5.1,48488,16.3,347479,67220,280259,2.8,14.3,544407,238691,305716,9.9,22.5,-196928,-8.2,28.6,0,35031,35059,190819,
2010,f) 5,238048,248548,2206635,2297834,12482,4.8,39921,15.2,320906,57861,263045,2.5,14,503304,214935,288369,9.4,21.9,-182398,-7.9,28,0,28579,28649,169700,
2010,g) 6 to 10,893465,948990,9522797,9844194,43241,4.4,119822,12.1,1231022,260656,970366,2.6,12.5,1873817,670273,1203544,6.8,19,-642795,-6.5,25,0,82018,82096,508948,
2010,h) 11 to 15,644555,717566,8591898,8799046,29596,4,71899,9.7,1014901,264294,750607,3,11.5,1429198,442318,986880,5,16.2,-414297,-4.7,23,0,46043,46174,306970,
2010,i) 16 to 20,462150,533793,7122406,7306656,21265,3.9,45054,8.3,773671,177497,596174,2.4,10.6,1142170,318665,823505,4.4,15.6,-368499,-5,21.2,0,28127,28196,197231,
2010,j) 21 to 25,371905,485722,8929782,9072978,18280,3.7,32935,6.7,862464,237678,624786,2.6,9.5,1148857,270996,877861,3,12.7,-286393,-3.2,19,0,19402,19543,139754,
2010,k) 26+,420363,686473,14508994,14662251,25711,3.7,39229,5.7,1457711,398292,1059419,2.7,9.9,1764225,406314,1357911,2.8,12,-306514,-2.1,19.8,0,19041,19417,156606,
2010,l) Left Censored,428980,1402055,49007454,49635836,66248,4.7,74680,5.3,4311027,1266141,3044886,2.6,8.7,5567791,1205797,4361994,2.4,11.2,-1256764,-2.5,17.4,0,16115,16541,203066,
2011,a) 0,409209,413970,2544797,1272399,413970,200,0,0,2544797,2544797,0,200,200,0,0,0,0,0,2544797,200,0,0,5,5,0,
2011,b) 1,291063,297903,2190512,2313273,835,0.2,98959,28.5,542097,25330,516767,1.1,23.4,787619,453144,334475,19.6,34,-245522,-10.6,46.8,0,79974,80070,394629,
2011,c) 2,263584,268140,2010355,2057903,15285,5.3,55523,19.3,416004,63607,352397,3.1,20.2,511099,276386,234713,13.4,24.8,-95095,-4.6,40.4,0,45936,45957,241996,
2011,d) 3,265902,271224,2078432,2112907,15053,5.2,49444,17.1,379889,62445,317444,3,18,448839,230357,218482,10.9,21.2,-68950,-3.2,36,0,40387,40415,198905,
2011,e) 4,248646,252923,2038520,2067934,14239,5.3,42215,15.8,358108,55216,302892,2.7,17.3,416935,202537,214398,9.8,20.2,-58827,-2.9,34.6,0,33713,33737,165150,
2011,f) 5,241861,256164,2266102,2288770,13365,5,38382,14.3,358367,61251,297116,2.7,15.7,403702,185054,218648,8.1,17.6,-45335,-1.9,31.4,0,30014,30095,154919,
2011,g) 6 to 10,905904,960487,9641789,9739147,44715,4.5,116844,11.7,1382927,256490,1126437,2.6,14.2,1577643,630351,947292,6.5,16.2,-194716,-2,28.4,0,89859,90085,515639,
2011,h) 11 to 15,643005,719052,8867421,8930662,30455,4.1,69556,9.4,1110627,219139,891488,2.5,12.4,1237109,429751,807358,4.8,13.9,-126482,-1.5,24.8,0,50721,50931,335197,
2011,i) 16 to 20,457362,521622,6982830,7026344,20214,3.8,44803,8.4,822981,195162,627819,2.8,11.7,910008,266693,643315,3.8,13,-87027,-1.3,23.4,0,32198,32384,197959,
2011,j) 21 to 25,371080,478689,8737829,8696743,17655,3.6,34942,7.2,994080,217761,776319,2.5,11.4,911908,279987,631921,3.2,10.5,82172,0.9,21,0,23445,23742,170383,
2011,k) 26+,469122,759807,16279267,16211267,28756,3.7,44312,5.8,1726452,425601,1300851,2.6,10.6,1590452,376271,1214181,2.3,9.8,136000,0.8,19.6,0,25987,26659,175234,
2011,l) Left Censored,411326,1388355,49574984,49183377,68237,4.9,64472,4.7,5093505,1271619,3821886,2.6,10.4,4310290,950972,3359318,1.9,8.8,783215,1.6,17.6,0,18499,19807,245767,
