year2,sic1,firms,estabs,emp,denom,estabs_entry,estabs_entry_rate,estabs_exit,estabs_exit_rate,job_creation,job_creation_births,job_creation_continuers,job_creation_rate_births,job_creation_rate,job_destruction,job_destruction_deaths,job_destruction_continuers,job_destruction_rate_deaths,job_destruction_rate,net_job_creation,net_job_creation_rate,reallocation_rate,firmdeath_firms,firmdeath_estabs,firmdeath_emp,d_flag
1977,07,35947,36979,275556,252515,7304,19.8,7083,19.2,105845,60740,45105,24.1,41.9,62384,28458,33926,11.3,24.7,43461,17.2,49.4,4998,5008,19337,0
1977,10,19362,25447,800273,769659,4347,17.5,3193,12.8,184197,75432,108765,9.8,23.9,123781,50050,73731,6.5,16.1,60416,7.8,32.2,1953,1965,20262,0
1977,15,383333,388884,3398225,3302074,81815,21.7,56838,15.1,981031,365548,615483,11.1,29.7,782855,261511,521344,7.9,23.7,198176,6,47.4,38156,38184,174684,0
1977,20,259981,316744,19325997,18845736,38803,12.4,31189,10,2725325,779437,1945888,4.1,14.5,1780764,544584,1236180,2.9,9.4,944561,5.1,18.8,21340,21425,252348,0
1977,40,121029,163437,4303455,4106004,24749,15.5,17463,10.9,980611,257679,722932,6.3,23.9,588484,139644,448840,3.4,14.3,392127,9.6,28.6,12009,12071,74494,0
1977,50,275195,367725,4758376,4610909,55679,15.4,41891,11.6,1086267,465449,620818,10.1,23.6,797682,365486,432196,7.9,17.3,288585,6.3,34.6,22787,23018,163950,0
1977,52,939853,1240960,13583781,13183094,231935,19,189236,15.5,3498785,1911315,1587470,14.5,26.5,2709327,1321269,1388058,10,20.6,789458,5.9,41.2,129340,130482,794134,0
1977,60,297794,388370,4519413,4396790,49177,12.8,39291,10.2,797984,294423,503561,6.7,18.1,554775,190312,364463,4.3,12.6,243209,5.5,25.2,25916,26031,97953,0
1977,70,1118359,1225225,15129162,14506949,203933,17.1,139822,11.7,3561689,1650045,1911644,11.4,24.6,2310975,1008011,1302964,6.9,15.9,1250714,8.7,31.8,94711,95108,634695,0
1978,07,37028,38049,259216,267386,7303,19.5,6144,16.4,82665,31566,51099,11.8,30.9,98721,35982,62739,13.5,36.9,-16056,-6,61.8,3817,3827,15971,0
1978,10,19537,25646,785877,793075,4017,15.7,3655,14.3,167582,56094,111488,7.1,21.1,180703,63522,117181,8,22.8,-13121,-1.7,42.2,1994,2003,18682,0
1978,15,410026,415497,3861546,3629885,91967,22.9,64182,16,1273929,420868,853061,11.6,35.1,802377,323112,479265,8.9,22.1,471552,13,44.2,43413,43434,202331,0
1978,20,262299,318595,20091116,19708970,37093,11.7,34909,11,2754618,628350,2126268,3.2,14,1995375,762184,1233191,3.9,10.1,759243,3.9,20.2,22500,22572,277877,0
1978,40,123279,166667,4352520,4327920,23991,14.5,20385,12.4,806705,216539,590166,5,18.6,755084,179866,575218,4.2,17.4,51621,1.2,34.8,13260,13331,84470,0
1978,50,278459,372447,4981320,4869916,43608,11.8,38451,10.4,1044559,311658,732901,6.4,21.4,819526,351536,467990,7.2,16.8,225033,4.6,33.6,22194,22449,122737,0
1978,52,922985,1231043,14268375,13927298,186590,15.1,194169,15.7,3418458,1519987,1898471,10.9,24.5,2718558,1248211,1470347,9,19.5,699900,5,39,129528,130582,665519,0
1978,60,303081,396927,4771048,4640386,50460,12.9,41109,10.5,830581,253149,577432,5.5,17.9,565670,232656,333014,5,12.2,264911,5.7,24.4,27510,27587,108810,0
1978,70,1146137,1257872,16301778,15693886,181873,14.6,145968,11.8,3686176,1121324,2564852,7.1,23.5,2455098,1086577,1368521,6.9,15.6,1231078,7.9,31.2,96647,97101,638034,0
1979,07,39345,40332,272601,265909,7771,19.8,5327,13.6,85805,37586,48219,14.1,32.3,71673,26115,45558,9.8,27,14132,5.3,54,3182,3201,14288,0
1979,10,20998,27195,915193,850535,4255,16.1,2705,10.2,237486,63767,173719,7.5,27.9,110731,40786,69945,4.8,13,126755,14.9,26,1106,1112,9625,0
1979,15,434038,439490,4307275,4084735,88545,20.7,61822,14.5,1355505,433603,921902,10.6,33.2,905144,308663,596481,7.6,22.2,450361,11,44.4,40532,40550,181001,0
1979,20,269016,326004,20856254,20473615,38771,12,30418,9.4,2839108,728843,2110265,3.6,13.9,2063905,758322,1305583,3.7,10.1,775203,3.8,20.2,18714,18851,230715,0
1979,40,129400,172634,4618404,4485589,24747,14.6,18197,10.7,850575,200226,650349,4.5,19,581885,167361,414524,3.7,13,268690,6,26,11114,11214,68380,0
1979,50,288907,383904,5193124,5086651,45165,11.9,32823,8.7,983479,334250,649229,6.6,19.3,767470,283462,484008,5.6,15.1,216009,4.2,30.2,17224,17422,109215,0
1979,52,938115,1257659,15010551,14637601,190193,15.3,158971,12.8,3357314,1625124,1732190,11.1,22.9,2593227,1026461,1566766,7,17.7,764087,5.2,35.4,100224,100749,537309,0
1979,60,313050,414056,5090485,4930529,54412,13.4,36223,8.9,903136,313926,589210,6.4,18.3,580890,188280,392610,3.8,11.8,322246,6.5,23.6,22806,22879,80156,0
1979,70,1197582,1315136,17758182,17046552,187931,14.6,125414,9.7,3830539,1258634,2571905,7.4,22.5,2392642,839276,1553366,4.9,14,1437897,8.5,28,78646,79085,443388,0
1980,07,40007,41005,276830,274715,6949,17.1,5824,14.3,73093,29339,43754,10.7,26.6,67039,24652,42387,9,24.4,6054,2.2,48.8,4150,4151,16570,0
1980,10,21618,27880,945490,930342,4397,16,3387,12.3,186114,61709,124405,6.6,20,151633,49304,102329,5.3,16.3,34481,3.7,32.6,2319,2341,25283,0
1980,15,421312,426568,4169171,4237795,71784,16.6,77810,18,1076539,338950,737589,8,25.4,1178054,381838,796216,9,27.8,-101515,-2.4,50.8,58783,58797,271741,0
1980,20,270330,327572,20690727,20772800,35641,10.9,32505,9.9,2518417,700576,1817841,3.4,12.1,2636114,783890,1852224,3.8,12.7,-117697,-0.6,24.2,23190,23304,271935,0
1980,40,130158,174001,4669688,4645291,22301,12.9,19703,11.4,809504,176096,633408,3.8,17.4,753257,152434,600823,3.3,16.2,56247,1.2,32.4,14581,14665,82200,0
1980,50,292228,387777,5287508,5239123,41604,10.8,35667,9.2,892967,329078,563889,6.3,17,783477,283672,499805,5.4,15,109490,2,30,22174,22337,123691,0
1980,52,924440,1250901,14957741,14981233,169959,13.6,168753,13.5,2971240,1504299,1466941,10,19.8,2973696,1126076,1847620,7.5,19.8,-2456,0,39.6,118920,119842,671006,0
1980,60,313399,416927,5227424,5156368,47204,11.4,41967,10.1,798800,272849,525951,5.3,15.5,648571,228869,419702,4.4,12.6,150229,2.9,25.2,29200,29315,111293,0
1980,70,1224649,1345940,18531616,18160397,180260,13.6,138755,10.4,3395373,1157681,2237692,6.4,18.7,2599586,917741,1681845,5.1,14.3,795787,4.4,28.6,98535,98984,558126,0
1981,07,40478,41432,286816,281604,7143,17.3,6642,16.1,82830,35672,47158,12.7,29.4,73317,35928,37389,12.8,26,9513,3.4,52,4308,4316,21263,0
1981,10,24376,30694,1054126,999503,6345,21.7,3795,13,258334,88270,170064,8.8,25.8,156048,63715,92333,6.4,15.6,102286,10.2,31.2,2273,2278,27237,0
1981,15,395668,400818,3983867,4071659,59851,14.5,81135,19.6,1024999,374018,650981,9.2,25.2,1210067,418141,791926,10.3,29.7,-185068,-4.5,50.4,55891,55912,255931,0
1981,20,268500,325399,19987528,20332143,35504,10.9,37577,11.5,2414717,871161,1543556,4.3,11.9,3109672,1037175,2072497,5.1,15.3,-694955,-3.4,23.8,23086,23183,309062,0
1981,40,126636,170237,4721582,4667533,21704,12.7,22253,13,878860,192731,686129,4.1,18.8,777275,215252,562023,4.6,16.7,101585,2.1,33.4,14080,14173,85344,0
1981,50,295544,388657,5307198,5295309,45200,11.6,44953,11.6,946982,389838,557144,7.4,17.9,934443,383766,550677,7.2,17.6,12539,0.3,35.2,22281,22472,129481,0
1981,52,902144,1218367,14724577,14836687,166324,13.5,197738,16,2841774,1493321,1348453,10.1,19.2,3080875,1416278,1664597,9.5,20.8,-239101,-1.6,38.4,115240,116340,654053,0
1981,60,306776,411941,5383716,5289843,46282,11.2,48392,11.7,884548,354030,530518,6.7,16.7,697538,255161,442377,4.8,13.2,187010,3.5,26.4,29914,30008,106300,0
1981,70,1234991,1353381,18093295,17792061,189159,14.1,166764,12.4,3430352,1416311,2014041,8,19.3,2848038,1210280,1637758,6.8,16,582314,3.3,32,99170,99627,557225,0
1982,07,42044,43162,312478,299652,7796,18.4,5537,13.1,96112,43506,52606,14.5,32.1,69219,25922,43297,8.7,23.1,26893,9,46.2,3093,3093,13767,0
1982,10,27274,33922,1114543,1084371,7635,23.6,4051,12.5,286740,103051,183689,9.5,26.4,225558,78900,146658,7.3,20.8,61182,5.6,41.6,2303,2306,29153,0
1982,15,375298,381267,3740943,3846841,57904,14.8,69595,17.8,997491,371173,626318,9.6,25.9,1188456,349179,839277,9.1,30.9,-190965,-5,51.8,39549,39554,199159,0
1982,20,271757,330225,19102711,19544309,38098,11.6,31628,9.6,2155615,747642,1407973,3.8,11,3025614,733751,2291863,3.8,15.5,-869999,-4.5,22,17840,17899,223037,0
1982,40,130165,176514,4817025,4768792,26038,15,18417,10.6,709020,259902,449118,5.5,14.9,615883,158375,457508,3.3,12.9,93137,2,25.8,10751,10776,72554,0
1982,50,305495,406000,5374626,5342756,54377,13.7,36169,9.1,1035353,464889,570464,8.7,19.4,966134,339553,626581,6.4,18.1,69219,1.3,36.2,18429,18497,113653,0
1982,52,905572,1268213,15318916,15032816,209956,16.9,154209,12.4,3517805,2043951,1473854,13.6,23.4,2921873,1110336,1811537,7.4,19.4,595932,4,38.8,90963,91199,534630,0
1982,60,299227,405250,5422955,5401446,48210,11.8,45176,11.1,829072,324777,504295,6,15.3,772099,243684,528415,4.5,14.3,56973,1,28.6,24576,24651,101215,0
1982,70,1282196,1426100,19270243,18705751,230245,16.6,140453,10.1,4091659,1894679,2196980,10.1,21.9,2930556,1013686,1916870,5.4,15.7,1161103,6.2,31.4,82585,82708,503634,0
1983,07,44317,45484,312139,312283,7531,17,5487,12.4,80419,33473,46946,10.7,25.8,81150,29457,51693,9.4,26,-731,-0.2,51.6,3423,3425,16959,0
1983,10,26430,32948,896173,999163,4642,13.9,5721,17.1,146166,65352,80814,6.5,14.6,352646,84223,268423,8.4,35.3,-206480,-20.7,29.2,3854,3861,40428,0
1983,15,375327,381185,3572726,3654698,55770,14.6,58330,15.3,921658,276866,644792,7.6,25.2,1093040,309310,783730,8.5,29.9,-171382,-4.7,50.4,37506,37516,192502,0
1983,20,271514,328988,17975044,18537268,30980,9.4,33126,10.1,1984779,581490,1403289,3.1,10.7,3111804,759676,2352128,4.1,16.8,-1127025,-6.1,21.4,21461,21545,252600,0
1983,40,131970,176523,4603846,4710417,24472,13.9,25407,14.4,1145531,471787,673744,10,24.3,1359655,642453,717202,13.6,28.9,-214124,-4.6,48.6,13453,13535,86087,0
1983,50,308314,406962,5178934,5274669,41383,10.2,41359,10.2,843045,294980,548065,5.6,16,1037738,336980,700758,6.4,19.7,-194693,-3.7,32,23810,23998,130079,0
1983,52,914856,1278690,15184689,15252322,163339,12.8,160217,12.6,2987548,1404195,1583353,9.2,19.6,3138989,1198381,1940608,7.9,20.6,-151441,-1,39.2,102760,103851,598572,0
1983,60,308678,417354,5500771,5460594,47446,11.5,42466,10.3,909869,347760,562109,6.4,16.7,836404,308329,528075,5.6,15.3,73465,1.4,30.6,25131,25225,115276,0
1983,70,1341541,1488551,19497040,19388395,195177,13.4,147437,10.1,3457624,1256130,2201494,6.5,17.8,3263427,988198,2275229,5.1,16.8,194197,1,33.6,97560,97921,536182,0
1984,07,47606,48762,349893,331019,8754,18.6,5477,11.6,102702,39239,63463,11.9,31,65067,24338,40729,7.4,19.7,37635,11.3,39.4,3318,3322,14616,0
1984,10,26095,32829,881118,888629,4813,14.6,4900,14.9,169796,56847,112949,6.4,19.1,184580,62774,121806,7.1,20.8,-14784,-1.7,38.2,3156,3157,25171,0
1984,15,403359,409173,4068013,3820264,77484,19.6,50922,12.9,1327068,400127,926941,10.5,34.7,836507,261113,575394,6.8,21.9,490561,12.8,43.8,32052,32068,169103,0
1984,20,278361,335516,19167655,18571514,36455,11,30057,9,3043124,748149,2294975,4,16.4,1880374,668490,1211884,3.6,10.1,1162750,6.3,20.2,18680,18779,186357,0
1984,40,136709,185236,4768793,4683042,29520,16.3,20508,11.3,953501,419132,534369,8.9,20.4,782140,227545,554595,4.9,16.7,171361,3.7,33.4,12233,12360,79969,0
1984,50,316126,415374,5506373,5341520,47442,11.5,38914,9.5,1071317,387116,684201,7.2,20.1,742055,285952,456103,5.4,13.9,329262,6.2,27.8,21295,21433,115225,0
1984,52,923227,1292944,16083028,15631472,174914,13.6,160694,12.5,3340220,1520966,1819254,9.7,21.4,2437453,1080721,1356732,6.9,15.6,902767,5.8,31.2,99648,100283,534104,0
1984,60,319630,431075,5816615,5652789,54084,12.8,40577,9.6,1072654,423581,649073,7.5,19,744004,246966,497038,4.4,13.2,328650,5.8,26.4,23707,23798,107271,0
1984,70,1419544,1571736,20745349,20087856,233308,15.2,152214,9.9,4061188,1562373,2498815,7.8,20.2,2753540,965392,1788148,4.8,13.7,1307648,6.5,27.4,95495,95899,526910,0
1985,07,51409,52647,381356,365402,9897,19.5,5861,11.6,112125,43697,68428,12,30.7,79702,28486,51216,7.8,21.8,32423,8.9,43.6,3870,3870,18536,0
1985,10,26454,33076,860801,871155,4629,14,4391,13.3,148352,48485,99867,5.6,17,168521,57697,110824,6.6,19.3,-20169,-2.3,34,2750,2763,22669,0
1985,15,429834,435655,4438059,4255407,81786,19.3,56606,13.4,1395958,448013,947945,10.5,32.8,1031940,350560,681380,8.2,24.3,364018,8.5,48.6,37637,37646,218176,0
1985,20,286080,342964,19206107,19186676,38289,11.3,30872,9.1,2433365,691612,1741753,3.6,12.7,2390868,884768,1506100,4.6,12.5,42497,0.2,25,19843,19933,265672,0
1985,40,144783,194830,4914932,4868758,28588,14.9,21565,11.3,826541,279814,546727,5.7,17,734119,236174,497945,4.9,15.1,92422,1.9,30.2,13422,13662,104483,0
1985,50,322999,423226,5638940,5571676,48825,11.6,40592,9.7,1001604,351175,650429,6.3,18,866884,359280,507604,6.4,15.6,134720,2.4,31.2,23437,23583,146428,0
1985,52,928358,1301659,16768200,16424917,179043,13.8,169660,13.1,3434233,1605015,1829218,9.8,20.9,2748139,1295550,1452589,7.9,16.7,686094,4.2,33.4,106801,107875,630767,0
1985,60,331338,446422,6013877,5894926,58456,13.3,44057,10,1089632,387920,701712,6.6,18.5,850189,316977,533212,5.4,14.4,239443,4.1,28.8,26788,26938,144462,0
1985,70,1488843,1646505,22669957,22141026,225527,14,157872,9.8,4249096,1553421,2695675,7,19.2,3199251,1198846,2000405,5.4,14.4,1049845,4.8,28.8,102960,103412,661975,0
1986,07,54821,56016,411474,396419,10486,19.3,6725,12.4,118610,46821,71789,11.8,29.9,87153,33736,53417,8.5,22,31457,7.9,44,4389,4391,20668,0
1986,10,25446,31723,781244,821053,3882,12,5093,15.7,129381,50770,78611,6.2,15.8,208244,65619,142625,8,25.4,-78863,-9.6,31.6,3415,3416,27155,0
1986,15,448989,454623,4670464,4554293,84869,19.1,63389,14.2,1391162,479149,912013,10.5,30.5,1148812,380371,768441,8.4,25.2,242350,5.3,50.4,43315,43327,246092,0
1986,20,287536,344369,18991502,19099841,38693,11.3,36224,10.5,2425214,829376,1595838,4.3,12.7,2612138,934784,1677354,4.9,13.7,-186924,-1,25.4,24538,24639,352551,0
1986,40,148695,200622,5021511,4967985,30345,15.3,23745,12,833776,291843,541933,5.9,16.8,721721,227175,494546,4.6,14.5,112055,2.3,29,15060,15204,107344,0
1986,50,330735,431073,5799863,5717827,51850,12.1,42753,10,1059807,417565,642242,7.3,18.5,891276,335727,555549,5.9,15.6,168531,2.9,31.2,25339,25416,146557,0
1986,52,939182,1324726,17473255,17114286,194091,14.8,166815,12.7,3716658,1870501,1846157,10.9,21.7,2985980,1258046,1727934,7.4,17.4,730678,4.3,34.8,109152,109992,696274,0
1986,60,338668,457632,6339558,6168064,59365,13.1,46627,10.3,1219529,446573,772956,7.2,19.8,872231,336596,535635,5.5,14.1,347298,5.7,28.2,28873,28934,149236,0
1986,70,1545481,1709624,23980576,23326427,238086,14.2,167620,10,4591319,1813904,2777415,7.8,19.7,3284599,1160739,2123860,5,14.1,1306720,5.6,28.2,110212,110476,656512,0
1987,07,58981,60202,436465,424010,11546,19.9,6808,11.7,121050,48928,72122,11.5,28.5,94175,36805,57370,8.7,22.2,26875,6.3,44.4,4715,4720,23243,0
1987,10,22746,28487,661162,721060,3435,11.4,6271,20.8,108169,42502,65667,5.9,15,224222,88286,135936,12.2,31.1,-116053,-16.1,30,3959,3994,33243,0
1987,15,472051,478183,4793600,4732611,91225,19.6,62618,13.4,1381809,462339,919470,9.8,29.2,1237721,427053,810668,9,26.2,144088,3,52.4,45110,45166,267597,0
1987,20,289358,345793,18569523,18784785,39136,11.3,36011,10.4,2190959,635645,1555314,3.4,11.7,2570298,918718,1651580,4.9,13.7,-379339,-2,23.4,23427,23574,282156,0
1987,40,153001,209211,5107955,5065171,36311,17.7,26512,12.9,1016838,469110,547728,9.3,20.1,921313,362972,558341,7.2,18.2,95525,1.9,36.4,16597,16881,171499,0
1987,50,333815,437422,5812584,5809267,56868,13.1,49348,11.4,1087419,408335,679084,7,18.7,1067541,445201,622340,7.7,18.4,19878,0.3,36.8,27068,27468,170271,0
1987,52,946386,1358937,18132035,17845267,218777,16.3,181488,13.5,4022985,2056073,1966912,11.5,22.5,3405602,1544951,1860651,8.7,19.1,617383,3.4,38.2,114102,115957,755723,0
1987,60,346822,467986,6558559,6449159,65356,14.1,52476,11.3,1214105,451277,762828,7,18.8,983660,381082,602578,5.9,15.3,230445,3.5,30.6,32380,32577,167362,0
1987,70,1593414,1779214,25580994,25051741,260320,14.9,184489,10.6,4784332,1864696,2919636,7.4,19.1,3939696,1539843,2399853,6.1,15.7,844636,3.4,31.4,122270,123105,833606,0
1988,07,61516,62632,466861,450697,10746,17.5,7774,12.7,130818,50199,80619,11.1,29,95258,37707,57551,8.4,21.1,35560,7.9,42.2,5311,5311,25109,0
1988,10,22224,27632,651152,655886,3521,12.6,4284,15.3,129801,42841,86960,6.5,19.8,138720,55651,83069,8.5,21.2,-8919,-1.4,39.6,2603,2603,16287,0
1988,15,479067,485127,4886810,4836705,81707,17,70784,14.7,1314929,428485,886444,8.9,27.2,1206968,394560,812408,8.2,25,107961,2.2,50,52348,52348,275666,0
1988,20,293378,349823,19047117,18808107,38347,11,33537,9.6,2695854,850265,1845589,4.5,14.3,2171228,779877,1391351,4.1,11.5,524626,2.8,23,22864,22864,234550,0
1988,40,151343,207601,5258952,5149134,29626,14.3,27201,13.2,910490,324258,586232,6.3,17.7,678021,261652,416369,5.1,13.2,232469,4.5,26.4,17137,17140,119545,0
1988,50,336811,441286,5961669,5886903,48825,11.1,43896,10,1112171,375806,736365,6.4,18.9,953242,374462,578780,6.4,16.2,158929,2.7,32.4,26562,26564,153894,0
1988,52,940693,1364234,18531315,18328788,187901,13.8,178661,13.1,3866368,1812255,2054113,9.9,21.1,3428144,1466531,1961613,8,18.7,438224,2.4,37.4,115175,115179,692303,0
1988,60,346708,482909,6618505,6564353,70146,14.8,52052,11,1267314,558129,709185,8.5,19.3,1155002,408311,746691,6.2,17.6,112312,1.7,35.2,32123,32123,171661,0
1988,70,1602649,1799924,25992497,25380936,230271,12.9,194193,10.9,5117717,1877747,3239970,7.4,20.2,3861501,1471998,2389503,5.8,15.2,1256216,5,30.4,134008,134018,737248,0
1989,07,64129,65320,508844,487780,11093,17.3,8379,13.1,147260,53473,93787,11,30.2,105963,40753,65210,8.4,21.7,41297,8.5,43.4,5131,5139,23417,0
1989,10,21407,26890,634252,642308,3109,11.4,3872,14.2,116466,45916,70550,7.1,18.1,133123,54488,78635,8.5,20.7,-16657,-2.6,36.2,2517,2526,21343,0
1989,15,482541,488568,4976399,4931542,78802,16.2,74587,15.3,1322340,405189,917151,8.2,26.8,1229376,430106,799270,8.7,24.9,92964,1.9,49.8,49756,49781,272371,0
1989,20,293262,351591,19399707,19222541,37331,10.6,36353,10.4,2553309,766344,1786965,4,13.3,2236043,780190,1455853,4.1,11.6,317266,1.7,23.2,23838,24045,341160,0
1989,40,152617,212456,5414254,5335843,30487,14.5,25984,12.4,957286,330919,626367,6.2,17.9,813915,301518,512397,5.7,15.3,143371,2.6,30.6,16164,16375,128164,0
1989,50,338914,446813,6148106,6054076,49397,11.1,44371,10,1101132,385084,716048,6.4,18.2,926456,385448,541008,6.4,15.3,174676,2.9,30.6,25818,26065,165097,0
1989,52,931454,1374320,19258916,18892347,180522,13.2,173115,12.6,3908465,1883547,2024918,10,20.7,3263875,1330925,1932950,7,17.3,644590,3.4,34.6,109646,111711,725638,0
1989,60,347161,484684,6760577,6678344,60899,12.6,58728,12.1,1235614,489919,745695,7.3,18.5,1078940,421214,657726,6.3,16.2,156674,2.3,32.4,31308,31483,191884,0
1989,70,1616966,1829465,27318721,26637911,226913,12.5,197978,10.9,5239574,1893245,3346329,7.1,19.7,3920981,1540538,2380443,5.8,14.7,1318593,5,29.4,128608,129438,857167,0
1990,07,70083,71283,557296,530326,13322,19.5,6887,10.1,166595,71928,94667,13.6,31.4,110264,34167,76097,6.4,20.8,56331,10.6,41.6,4843,4856,23386,0
1990,10,21355,26779,646706,640338,3289,12.3,3278,12.2,114329,36081,78248,5.6,17.9,101328,38357,62971,6,15.8,13001,2.1,31.6,2163,2181,18300,0
1990,15,497610,503575,5133118,5054647,86220,17.4,65446,13.2,1383360,448699,934661,8.9,27.4,1198990,373871,825119,7.4,23.7,184370,3.7,47.4,48905,48936,282093,0
1990,20,298042,357313,19142592,19271990,38755,10.9,31401,8.9,2060413,632425,1427988,3.3,10.7,2317055,643621,1673434,3.3,12,-256642,-1.3,21.4,22812,22920,288791,0
1990,40,157115,217883,5564871,5490128,30514,14.2,23844,11.1,876969,286462,590507,5.2,16,724716,254607,470109,4.6,13.2,152253,2.8,26.4,15487,15604,115479,0
1990,50,346539,457595,6326031,6235167,51840,11.5,39095,8.6,1070397,386088,684309,6.2,17.2,882994,311463,571531,5,14.2,187403,3,28.4,24560,24731,154027,0
1990,52,938646,1391020,19638103,19445093,180170,13,157274,11.4,3619431,1707099,1912332,8.8,18.6,3210549,1249828,1960721,6.4,16.5,408882,2.1,33,104121,105280,710363,0
1990,60,354163,495794,6877047,6809948,61292,12.5,47526,9.7,1202440,474652,727788,7,17.7,1061296,367039,694257,5.4,15.6,141144,2.1,31.2,28743,28994,164690,0
1990,70,1666834,1890978,28698515,28016977,242004,13,168221,9,5174639,1835848,3338791,6.6,18.5,3770298,1318652,2451646,4.7,13.5,1404341,5,27,119911,120462,777540,0
1991,07,73351,74597,617398,586433,11285,15.5,7937,10.9,194377,59768,134609,10.2,33.1,134237,40389,93848,6.9,22.9,60140,10.2,45.8,4930,4933,25688,0
1991,10,21518,26932,647963,647222,3231,12,3181,11.8,108694,42480,66214,6.6,16.8,108724,39234,69490,6.1,16.8,-30,0,33.6,1967,1970,16877,0
1991,15,492021,498018,4593796,4863503,71723,14.3,75885,15.2,988343,329400,658943,6.8,20.3,1526535,420346,1106189,8.6,31.4,-538192,-11.1,40.6,50359,50400,284281,0
1991,20,298239,357772,18290437,18716319,34211,9.6,33802,9.5,1824339,574617,1249722,3.1,9.7,2640187,745023,1895164,4,14.1,-815848,-4.4,19.4,23274,23516,323274,0
1991,40,159381,226638,5584868,5565659,34936,15.7,26011,11.7,962249,411344,550905,7.4,17.3,929454,298990,630464,5.4,16.7,32795,0.6,33.4,15387,15822,130549,0
1991,50,352108,465152,6225093,6274462,50525,11,43037,9.3,951842,364805,587037,5.8,15.2,1051430,357582,693848,5.7,16.8,-99588,-1.6,30.4,25031,25362,167639,0
1991,52,943016,1398952,19408157,19518418,172034,12.3,164289,11.8,3319267,1627601,1691666,8.3,17,3549883,1311639,2238244,6.7,18.2,-230616,-1.2,34,100708,103798,723063,0
1991,60,353724,525779,6867923,6864756,83074,16.3,53093,10.4,1458300,810537,647763,11.8,21.2,1454131,478429,975702,7,21.2,4169,0,42.4,29809,30089,234808,0
1991,70,1711384,1948408,29207492,28938949,233793,12.2,176896,9.2,4832139,1800522,3031617,6.2,16.7,4340995,1475384,2865611,5.1,15,491144,1.7,30,116566,117678,868432,0
1992,07,75464,76765,600939,592108,11523,15.2,8339,11,161454,57573,103881,9.7,27.3,140534,62347,78187,10.5,23.7,20920,3.6,47.4,5512,5519,24436,0
1992,10,20603,25808,598937,623530,2749,10.4,3646,13.8,97034,36698,60336,5.9,15.6,143820,50359,93461,8.1,23.1,-46786,-7.5,31.2,2304,2325,19408,0
1992,15,487453,493493,4454507,4523864,75411,15.2,71940,14.5,1095397,322806,772591,7.1,24.2,1204580,349777,854803,7.7,26.6,-109183,-2.4,48.4,51075,51109,249281,0
1992,20,294986,353619,18039645,18165034,32247,9.1,34321,9.6,2007795,526415,1481380,2.9,11.1,2238530,672528,1566002,3.7,12.3,-230735,-1.2,22.2,24238,24417,283170,0
1992,40,160983,234115,5496887,5539884,36020,15.6,26757,11.6,883997,347209,536788,6.3,16,952343,295226,657117,5.3,17.2,-68346,-1.2,32,16394,16645,121421,0
1992,50,352859,465009,6149247,6192292,48966,10.5,47781,10.3,1040667,344677,695990,5.6,16.8,1113097,407857,705240,6.6,18,-72430,-1.2,33.6,27691,28796,169787,0
1992,52,936198,1395130,19340388,19391785,175859,12.6,176807,12.6,3393366,1591765,1801601,8.2,17.5,3449292,1349040,2100252,7,17.8,-55926,-0.3,35,107337,111655,703752,0
1992,60,355491,539011,6775669,6799725,68954,13,52583,9.9,1297287,506380,790907,7.4,19.1,1338300,445237,893063,6.5,19.7,-41013,-0.6,38.2,28570,29382,179549,0
1992,70,1736481,1993364,30270607,29756623,242815,12.3,191421,9.7,5528614,2010693,3517921,6.8,18.6,4445470,1621401,2824069,5.4,14.9,1083144,3.7,29.8,128800,130476,962078,0
1993,07,77115,78374,622930,604425,10743,13.9,8238,10.7,175487,51689,123798,8.6,29,137078,44811,92267,7.4,22.7,38409,6.3,45.4,5526,5528,26527,0
1993,10,19982,25118,551313,574942,2655,10.4,3238,12.7,89524,31591,57933,5.5,15.6,137049,50896,86153,8.9,23.8,-47525,-8.2,31.2,2077,2084,16788,0
1993,15,496514,502344,4486377,4470336,78289,15.7,66162,13.3,1142083,329380,812703,7.4,25.5,1099018,325943,773075,7.3,24.6,43065,0.9,49.2,48317,48336,240033,0
1993,20,297234,355334,18017789,18028718,33630,9.5,31222,8.8,1995810,494498,1501312,2.7,11.1,2042783,583442,1459341,3.2,11.3,-46973,-0.2,22.2,22557,22668,240318,0
1993,40,166403,239014,5570521,5533173,31671,13.4,26254,11.1,842462,260722,581740,4.7,15.2,773178,257909,515269,4.7,14,69284,1.2,28,15859,16050,102327,0
1993,50,356454,467339,6168895,6158365,45931,9.9,42322,9.1,963098,289995,673103,4.7,15.6,938475,316664,621811,5.1,15.2,24623,0.4,30.4,26893,27283,152765,0
1993,52,942202,1391455,19850506,19594872,158080,11.3,159676,11.5,3590151,1473545,2116606,7.5,18.3,3083739,1213104,1870635,6.2,15.7,506412,2.6,31.4,101223,103060,620324,0
1993,60,362440,541005,6700623,6707291,58784,10.9,53908,10,1205603,449096,756507,6.7,18,1216596,491026,725570,7.3,18.1,-10993,-0.1,36,26912,27722,128007,0
1993,70,1771886,2030338,31329761,30806854,226978,11.3,184319,9.2,5331275,1730070,3601205,5.6,17.3,4270365,1394999,2875366,4.5,13.9,1060910,3.4,27.8,129786,130461,781287,0
1994,07,79856,81166,603600,611156,11654,14.6,8308,10.4,159319,51722,107597,8.5,26.1,172532,46399,126133,7.6,28.2,-13213,-2.1,52.2,5713,5713,24951,0
1994,10,19521,24636,547126,549211,2448,9.8,2920,11.7,87642,31047,56595,5.7,16,92930,31851,61079,5.8,16.9,-5288,-0.9,32,1900,1908,13891,0
1994,15,511471,517462,4664777,4575118,82882,16.3,64816,12.7,1214492,361460,853032,7.9,26.5,1021281,317987,703294,7,22.3,193211,4.2,44.6,47472,47479,234987,0
1994,20,298727,357455,18019674,18020287,34176,9.6,31135,8.7,1985400,531046,1454354,2.9,11,1984852,609607,1375245,3.4,11,548,0,22,22606,22718,261367,0
1994,40,172399,246998,5673860,5622156,34796,14.3,26164,10.8,846224,293918,552306,5.2,15.1,740772,251652,489120,4.5,13.2,105452,1.9,26.4,16552,16728,107267,0
1994,50,359783,471413,6245733,6206568,47790,10.2,42389,9,974249,300909,673340,4.8,15.7,888757,321712,567045,5.2,14.3,85492,1.4,28.6,27205,27571,154353,0
1994,52,943664,1398742,20171461,20007299,166701,12,155915,11.2,3526251,1686545,1839706,8.4,17.6,3184951,1199467,1985484,6,15.9,341300,1.7,31.8,103143,104319,630051,0
1994,60,372729,557412,6886017,6788457,68919,12.6,51618,9.4,1292353,522178,770175,7.7,19,1098066,413363,684703,6.1,16.2,194287,2.8,32.4,26511,26843,117498,0
1994,70,1805427,2071625,32174778,31725792,239273,11.7,190030,9.3,5257286,1819379,3437907,5.7,16.6,4316641,1497150,2819491,4.7,13.6,940645,3,27.2,132639,133429,878216,0
1995,07,83672,85045,627484,609303,12939,15.6,8328,10,153110,53193,99917,8.7,25.1,115856,36024,79832,5.9,19,37254,6.1,38,5821,5821,23645,0
1995,10,18970,23917,545695,546280,2281,9.4,2758,11.4,94198,27239,66959,5,17.2,95538,34921,60617,6.4,17.5,-1340,-0.3,34.4,1786,1799,14444,0
1995,15,531258,537337,4972958,4818399,87924,16.7,64565,12.2,1253352,374014,879338,7.8,26,931735,303711,628024,6.3,19.3,321617,6.7,38.6,48097,48107,230534,0
1995,20,301281,360875,18533570,18277565,34358,9.6,30018,8.4,2178890,531002,1647888,2.9,11.9,1662421,509627,1152794,2.8,9.1,516469,2.8,18.2,22109,22167,229055,0
1995,40,179752,255527,5887967,5778797,36346,14.5,26886,10.7,943048,324735,618313,5.6,16.3,722512,239651,482861,4.1,12.5,220536,3.8,25,16982,17121,109312,0
1995,50,366121,479175,6512098,6377663,50049,10.5,40897,8.6,1069998,330177,739821,5.2,16.8,797061,290647,506414,4.6,12.5,272937,4.3,25,26202,26472,143896,0
1995,52,948864,1406885,20954084,20557410,170437,12.2,157855,11.3,3792113,1789868,2002245,8.7,18.4,2980176,1240553,1739623,6,14.5,811937,3.9,29,101300,102683,616632,0
1995,60,376531,568060,6837389,6844972,66325,11.8,52338,9.3,1067568,432547,635021,6.3,15.6,1075222,349575,725647,5.1,15.7,-7654,-0.1,31.2,29044,29557,134342,0
1995,70,1845162,2122712,33648209,32910371,251978,12,191997,9.2,5687908,2047382,3640526,6.2,17.3,4193674,1435488,2758186,4.4,12.7,1494234,4.6,25.4,135828,136640,841183,0
1996,07,86168,87663,672835,651230,12140,14.1,9002,10.4,156340,55681,100659,8.6,24,110331,39455,70876,6.1,16.9,46009,7.1,33.8,6232,6232,25151,0
1996,10,18404,23335,527824,536703,2238,9.5,2740,11.6,77323,22454,54869,4.2,14.4,95500,36273,59227,6.8,17.8,-18177,-3.4,28.8,1784,1785,16447,0
1996,15,541222,547303,5130627,5051639,81624,15.1,69146,12.8,1185929,356778,829151,7.1,23.5,1029640,324641,704999,6.4,20.4,156289,3.1,40.8,50638,50638,239196,0
1996,20,302303,362263,18445885,18485707,32806,9.1,31383,8.7,1913066,537668,1375398,2.9,10.3,2060506,612001,1448505,3.3,11.1,-147440,-0.8,20.6,22590,22594,240141,0
1996,40,184688,261144,5987401,5935789,37361,14.5,31014,12,985400,364914,620486,6.1,16.6,885527,331562,553965,5.6,14.9,99873,1.7,29.8,18731,18734,115216,0
1996,50,370670,485603,6577590,6543663,51740,10.7,44822,9.3,1020898,340342,680556,5.2,15.6,964285,356591,607694,5.4,14.7,56613,0.9,29.4,27981,27987,160556,0
1996,52,954234,1418299,21355568,21148449,171698,12.2,157976,11.2,3696977,1787963,1909014,8.5,17.5,3287761,1280941,2006820,6.1,15.5,409216,2,31,103978,104020,649894,0
1996,60,384054,576722,6991700,6914294,64165,11.2,53484,9.3,1183259,452992,730267,6.6,17.1,1032531,371074,661457,5.4,14.9,150728,2.2,29.8,28308,28314,120660,0
1996,70,1884865,2171486,34690371,34161248,258868,12.1,204161,9.5,5845174,2156355,3688819,6.3,17.1,4823912,1676528,3147384,4.9,14.1,1021262,3,28.2,141427,141463,900767,0
1997,07,89062,90773,711402,689309,12945,14.5,9307,10.4,171689,55099,116590,8,24.9,125120,46560,78560,6.8,18.2,46569,6.7,36.4,6466,6466,30242,0
1997,10,18210,23105,525298,526443,2495,10.8,2676,11.5,102111,33925,68186,6.4,19.4,107842,43509,64333,8.3,20.5,-5731,-1.1,38.8,1568,1568,17818,0
1997,15,554808,560817,5424988,5277755,83863,15.1,68053,12.3,1309139,378343,930796,7.2,24.8,1007312,341713,665599,6.5,19.1,301827,5.7,38.2,49971,49971,242170,0
1997,20,302129,361299,18519916,18482177,32188,8.9,32591,9,2105550,494766,1610784,2.7,11.4,2027067,723587,1303480,3.9,11,78483,0.4,22,22634,22634,247527,0
1997,40,187294,266126,6146410,6070074,38408,14.6,33502,12.7,1080971,395527,685444,6.5,17.8,926584,346963,579621,5.7,15.3,154387,2.5,30.6,19963,19965,134565,0
1997,50,371291,486851,6720139,6653479,49739,10.2,48648,10,1163810,351913,811897,5.3,17.5,1025702,404833,620869,6.1,15.4,138108,2.1,30.8,28707,28708,168245,0
1997,52,952176,1424164,21775694,21589835,182694,12.8,178538,12.5,4111800,1928496,2183304,8.9,19,3714029,1484044,2229985,6.9,17.2,397771,1.8,34.4,106712,106712,678792,0
1997,60,391964,594517,7199271,7101437,82874,14.1,65004,11.1,1553766,665676,888090,9.4,21.9,1349885,606379,743506,8.5,19,203881,2.9,38,29025,29025,154930,0
1997,70,1920262,2235560,36180478,35484700,289058,13.1,224729,10.2,6925402,2571108,4354294,7.2,19.5,5513436,1998274,3515162,5.6,15.5,1411966,4,31,148656,148659,1.02E6,0
1998,07,90982,92755,717283,711776,12509,13.6,10009,10.9,152515,52944,99571,7.4,21.4,140584,47159,93425,6.6,19.8,11931,1.6,39.6,6982,6982,29717,0
1998,10,17829,22611,517647,521407,2219,9.7,2624,11.5,94766,29268,65498,5.6,18.2,102168,39844,62324,7.6,19.6,-7402,-1.4,36.4,1558,1558,17717,0
1998,15,561604,567888,5601491,5513062,80713,14.3,71041,12.6,1262604,369885,892719,6.7,22.9,1073131,351945,721186,6.4,19.5,189473,3.4,39,51869,51869,255063,0
1998,20,300832,360706,18723746,18621656,31762,8.8,31693,8.8,2103363,526563,1576800,2.8,11.3,1892910,595045,1297865,3.2,10.2,210453,1.1,20.4,22650,22650,245814,0
1998,40,188868,273670,6305073,6227227,40565,15,32347,12,1068568,405079,663489,6.5,17.2,910126,365409,544717,5.9,14.6,158442,2.6,29.2,20631,20631,148858,0
1998,50,366728,482337,6828795,6776188,43603,9,47061,9.7,1074509,305831,768678,4.5,15.9,965480,370838,594642,5.5,14.2,109029,1.7,28.4,30041,30041,174987,0
1998,52,945314,1417971,22089418,21931937,158255,11.1,161237,11.3,3707508,1603942,2103566,7.3,16.9,3374256,1378986,1995270,6.3,15.4,333252,1.5,30.8,105556,105556,663521,0
1998,60,397753,601849,7308781,7253479,72669,12.1,64169,10.7,1378078,511753,866325,7.1,19,1272223,534398,737825,7.4,17.5,105855,1.5,35,30339,30359,147839,0
1998,70,1949044,2275035,37621560,36889309,269636,12,223753,9.9,6619963,2277322,4342641,6.2,17.9,5123724,1840669,3283055,5,13.9,1496239,4,27.8,153448,153448,989606,0
1999,07,93402,95261,772400,742282,12703,13.5,9910,10.5,180560,51606,128954,7,24.3,120060,45484,74576,6.1,16.2,60500,8.1,32.4,6821,6821,32100,0
1999,10,16793,21655,478524,497924,1918,8.7,2749,12.4,65185,20105,45080,4,13.1,103330,33599,69731,6.7,20.8,-38145,-7.7,26.2,1710,1710,13698,0
1999,15,572349,578912,5967723,5784886,80167,14,68096,11.9,1388135,379552,1008583,6.6,24,1015054,359847,655207,6.2,17.5,373081,6.5,35,49204,49204,257641,0
1999,20,296165,356859,18388032,18555398,29211,8.1,32581,9.1,1838578,495548,1343030,2.7,9.9,2161533,655644,1505889,3.5,11.6,-322955,-1.7,19.8,23047,23047,263829,0
1999,40,190929,277601,6491773,6401880,38916,14.1,34910,12.7,1123647,442284,681363,6.9,17.6,944413,397747,546666,6.2,14.8,179234,2.8,29.6,20764,20764,133803,0
1999,50,360506,477231,6948504,6887491,41704,8.7,45950,9.6,1084297,341225,743072,5,15.7,957883,374777,583106,5.4,13.9,126414,1.8,27.8,29444,29444,169485,0
1999,52,937430,1411774,22434524,22261926,151908,10.7,156597,11.1,3674619,1634538,2040081,7.3,16.5,3326941,1313119,2013822,5.9,14.9,347678,1.6,29.8,102020,102020,647056,0
1999,60,404604,617928,7497168,7396887,80321,13.2,63522,10.4,1489992,605516,884476,8.2,20.1,1297108,573655,723453,7.8,17.5,192884,2.6,35,31242,31242,144755,0
1999,70,1967007,2306625,39069865,38542768,262408,11.5,228779,10,6665230,2301605,4363625,6,17.3,5592757,2141838,3450919,5.6,14.5,1072473,2.8,29,153390,153390,1.03E6,0
2000,07,95912,97749,822683,790545,13031,13.5,10515,10.9,204087,66956,137131,8.5,25.8,139527,57881,81646,7.3,17.6,64560,8.2,35.2,6943,6943,36995,0
2000,10,16583,21562,468323,473182,2128,9.8,2237,10.4,79106,22179,56927,4.7,16.7,87965,26423,61542,5.6,18.6,-8859,-1.9,33.4,1372,1372,9581,0
2000,15,576422,583377,6332252,6148475,75656,13,71541,12.3,1441336,368841,1072495,6,23.4,1073991,365292,708699,5.9,17.5,367345,5.9,35,49770,49770,257454,0
2000,20,291745,353241,18281574,18333706,29476,8.3,33231,9.4,2042081,554963,1487118,3,11.1,2149164,722046,1427118,3.9,11.7,-107083,-0.6,22.2,22445,22445,245059,0
2000,40,190325,279846,6755254,6619600,39506,14.2,37281,13.4,1200090,463167,736923,7,18.1,930952,398342,532610,6,14.1,269138,4,28.2,21166,21166,131198,0
2000,50,354667,470365,7030099,6988316,40551,8.6,47386,10,1125235,352327,772908,5,16.1,1042519,452579,589940,6.5,14.9,82716,1.2,29.8,27938,27938,187282,0
2000,52,933654,1414307,23028671,22730938,154497,10.9,152937,10.8,3865672,1694223,2171449,7.5,17,3274319,1355159,1919160,6,14.4,591353,2.6,28.8,96776,96789,607640,0
2000,60,407380,623707,7583250,7540054,75849,12.2,70498,11.4,1411825,573087,838738,7.6,18.7,1332621,526368,806253,7,17.7,79204,1,35.4,31838,31838,142015,0
2000,70,1978530,2327678,40915483,39995738,257395,11.1,236807,10.2,7304682,2463665,4841017,6.2,18.3,5469545,2158374,3311171,5.4,13.7,1835137,4.6,27.4,149699,149699,988192,0
2001,07,101577,103785,975113,953513,13714,13.4,11907,11.6,255784,93337,162447,9.8,26.8,219586,73275,146311,7.7,23,36198,3.8,46,6917,6917,32929,0
2001,10,16917,21897,488840,478882,2213,10.2,2196,10.1,87223,24612,62611,5.1,18.2,69213,24704,44509,5.2,14.5,18010,3.7,29,1220,1220,9253,0
2001,15,574944,582287,6376617,6355004,71389,12.2,77521,13.3,1284100,366406,917694,5.8,20.2,1266917,427882,839035,6.7,19.9,17183,0.3,39.8,49918,49920,268233,0
2001,20,287653,349133,17764980,18025518,27458,7.8,33689,9.6,1756328,486704,1269624,2.7,9.7,2314283,662825,1651458,3.7,12.8,-557955,-3.1,19.4,21847,21849,236210,0
2001,40,189951,288372,6825561,6792815,44170,15.5,38037,13.4,1138027,500448,637579,7.4,16.8,1093352,402986,690366,5.9,16.1,44675,0.7,32.2,20871,20877,137303,0
2001,50,348302,466138,7085118,7070330,41255,8.8,48510,10.3,1104314,385569,718745,5.5,15.6,1093532,402378,691154,5.7,15.5,10782,0.1,31,27825,27857,166859,0
2001,52,931542,1415384,23087208,23063744,151455,10.7,157938,11.2,3551518,1586252,1965266,6.9,15.4,3558274,1354280,2203994,5.9,15.4,-6756,0,30.8,96081,96217,618714,0
2001,60,413318,636040,7954470,7774723,78471,12.5,70298,11.2,1644553,693277,951276,8.9,21.2,1319111,567611,751500,7.3,17,325442,4.2,34,31993,32001,151109,0
2001,70,1999330,2358285,41713930,41352036,260181,11.1,246537,10.5,6815446,2328068,4487378,5.6,16.5,6250857,2220906,4029951,5.4,15.1,564589,1.4,30.2,149090,149244,992283,0
2002,07,103810,106690,998107,999212,15838,14.9,15550,14.6,238752,101106,137646,10.1,23.9,240962,87450,153512,8.8,24.1,-2210,-0.2,47.8,6790,6793,32093,0
2002,10,17242,22374,478723,487242,2532,11.3,2515,11.2,86086,34657,51429,7.1,17.7,103123,39202,63921,8,21.2,-17037,-3.5,35.4,1192,1192,10538,0
2002,15,571664,579554,6213085,6316699,77201,13.3,81957,14.1,1242181,392310,849871,6.2,19.7,1434310,430646,1003664,6.8,22.7,-192129,-3,39.4,48153,48168,260753,0
2002,20,283279,342725,16273730,17055751,29189,8.4,38262,11,1624925,617095,1007830,3.6,9.5,3159212,937588,2221624,5.5,18.5,-1534287,-9,19,22731,22826,284611,0
2002,40,190780,293161,6690131,6803434,44496,15.2,44676,15.2,1178254,620878,557376,9.1,17.3,1387342,475012,912330,7,20.4,-209088,-3.1,34.6,21087,21134,133526,0
2002,50,349882,465978,6915414,7018560,49954,10.7,55702,11.9,1191534,482578,708956,6.9,17,1382962,530976,851986,7.6,19.7,-191428,-2.7,34,26771,26890,167700,0
2002,52,948937,1442063,23431062,23389215,181802,12.7,171655,11.9,4061775,1944543,2117232,8.3,17.4,3965224,1468486,2496738,6.3,17,96551,0.4,34,94835,95222,605725,0
2002,60,429646,662223,8384091,8230449,87927,13.4,73965,11.3,1726032,755819,970213,9.2,21,1458323,563898,894425,6.9,17.7,267709,3.3,35.4,30327,30372,141654,0
2002,70,2053868,2440434,42411284,42491373,310871,12.8,269500,11.1,7578223,2934320,4643903,6.9,17.8,7671161,2900446,4770715,6.8,18.1,-92938,-0.3,35.6,149203,149668,1.07E6,0
2003,07,104563,107583,997966,992097,15822,14.8,12775,12,215695,81240,134455,8.2,21.7,197181,75242,121939,7.6,19.9,18514,1.8,39.8,7120,7120,39607,0
2003,10,16775,21609,449136,458555,2054,9.5,1990,9.2,72570,25900,46670,5.6,15.8,89816,28439,61377,6.2,19.6,-17246,-3.8,31.6,1298,1308,11812,0
2003,15,556361,564256,6079691,6142022,65446,11.4,72104,12.6,1199780,311744,888036,5.1,19.5,1289704,364454,925250,5.9,21,-89924,-1.5,39,49153,49155,254928,0
2003,20,277162,334565,15667048,15886461,26114,7.7,29317,8.7,1604448,470210,1134238,3,10.1,2018868,550873,1467995,3.5,12.7,-414420,-2.6,20.2,21805,21917,267922,0
2003,40,189123,292245,6599549,6607108,40694,14,35425,12.2,1207522,559030,648492,8.5,18.3,1015028,385988,629040,5.8,15.4,192494,2.9,30.8,21069,21115,128443,0
2003,50,346962,459692,6883478,6856579,41118,8.9,39051,8.5,1026885,312989,713896,4.6,15,950752,306068,644684,4.5,13.9,76133,1.1,27.8,26326,26478,171479,0
2003,52,955623,1449637,23936408,23541496,165008,11.5,129049,9,3924018,1688941,2235077,7.2,16.7,3083761,1025552,2058209,4.4,13.1,840257,3.6,26.2,94881,95160,645354,0
2003,60,441590,684890,8399632,8357993,93549,14,59856,8.9,1584845,654581,930264,7.8,19,1485669,530602,955067,6.3,17.8,99176,1.2,35.6,31332,31400,153759,0
2003,70,2101912,2486970,43236896,42662372,301737,12.3,216534,8.8,7177219,2416409,4760810,5.7,16.8,5915319,1850392,4064927,4.3,13.9,1261900,2.9,27.8,149417,150744,1.07E6,0
2004,07,107658,110771,1038529,1014641,16545,15.2,12480,11.4,231306,81507,149799,8,22.8,178929,70911,108018,7,17.6,52377,5.2,35.2,7239,7239,43128,0
2004,10,17059,21738,464961,455975,2122,9.8,1797,8.3,79131,27256,51875,6,17.4,60450,21791,38659,4.8,13.3,18681,4.1,26.6,1053,1055,8659,0
2004,15,545091,552648,6141159,6100522,61510,11,68199,12.2,1227727,265561,962166,4.4,20.1,1123951,349701,774250,5.7,18.4,103776,1.7,36.8,48243,48248,258194,0
2004,20,273247,329601,15231747,15379199,25753,7.8,27484,8.3,1521801,418989,1102812,2.7,9.9,1799811,529732,1270079,3.4,11.7,-278010,-1.8,19.8,20159,20211,254240,0
2004,40,189505,293242,6578173,6587494,39108,13.4,34625,11.9,1076403,389537,686866,5.9,16.3,1072785,385504,687281,5.9,16.3,3618,0,32.6,19442,19492,128573,0
2004,50,345102,458879,6910156,6871916,40637,8.9,37591,8.2,985304,318490,666814,4.6,14.3,898710,311755,586955,4.5,13.1,86594,1.2,26.2,25166,25295,152089,0
2004,52,964835,1456227,24503668,24126271,160465,11.1,137405,9.5,3950620,1580585,2370035,6.6,16.4,3164223,1176385,1987838,4.9,13.1,786397,3.3,26.2,96580,97232,657005,0
2004,60,455743,696180,8458007,8401810,86584,12.6,67889,9.9,1531046,616612,914434,7.3,18.2,1406935,572215,834720,6.8,16.7,124111,1.5,33.4,31261,31360,157227,0
2004,70,2166160,2560456,44112241,43543032,311723,12.4,216190,8.6,6869001,2429205,4439796,5.6,15.8,5662560,1899855,3762705,4.4,13,1206441,2.8,26,147155,147621,1.03E6,0
2005,07,111052,114281,1135436,1086992,16845,15,12813,11.4,296841,99265,197576,9.1,27.3,196880,68674,128206,6.3,18.1,99961,9.2,36.2,7574,7574,39131,0
2005,10,17601,22386,482465,472455,2410,10.9,1621,7.4,85097,27950,57147,5.9,18,64866,21443,43423,4.5,13.7,20231,4.3,27.4,1053,1053,11773,0
2005,15,531037,538665,6072426,6103223,57290,10.5,68397,12.5,1156406,277411,878995,4.5,18.9,1207719,367063,840656,6,19.8,-51313,-0.9,37.8,49808,49813,271885,0
2005,20,271603,327368,15132014,15138943,25626,7.8,25543,7.8,1594445,428156,1166289,2.8,10.5,1596141,464289,1131852,3.1,10.5,-1696,0,21,18943,18983,236390,0
2005,40,192577,297104,6554931,6554602,38879,13.2,32746,11.1,964766,391063,573703,6,14.7,974200,327021,647179,5,14.9,-9434,-0.2,29.4,18870,19028,142099,0
2005,50,344352,461759,6955530,6918562,42504,9.3,36466,7.9,996217,349184,647033,5,14.4,914637,298908,615729,4.3,13.2,81580,1.2,26.4,25226,25299,156902,0
2005,52,978419,1479453,24807162,24575913,172221,11.8,133280,9.1,3878079,1847826,2030253,7.5,15.8,3394236,1060788,2333448,4.3,13.8,483843,2,27.6,101722,102252,748166,0
2005,60,473046,720384,8433581,8420954,102026,14.5,71070,10.1,1496053,716782,779271,8.5,17.8,1453890,611055,842835,7.3,17.3,42163,0.5,34.6,33570,33694,180297,0
2005,70,2246082,2652735,45268460,44597210,330009,12.7,218891,8.4,7122612,2645343,4477269,5.9,16,5747242,1870404,3876838,4.2,12.9,1375370,3.1,25.8,151569,152016,1.14E6,0
2006,07,115010,118600,1132832,1133670,18742,16.1,13906,11.9,270203,98039,172164,8.6,23.8,268494,93527,174967,8.2,23.7,1709,0.1,47.4,8504,8506,68200,0
2006,10,18472,23707,542740,511966,3242,14.1,1795,7.8,121524,45807,75717,8.9,23.7,59118,26291,32827,5.1,11.5,62406,12.2,23,1112,1114,12653,0
2006,15,524603,532521,6349583,6207611,57744,10.8,62356,11.6,1298812,281087,1017725,4.5,20.9,1011374,313828,697546,5.1,16.3,287438,4.6,32.6,43855,43920,227375,0
2006,20,269220,325965,15088885,15066263,26667,8.2,26233,8,1603587,451338,1152249,3,10.6,1556479,472158,1084321,3.1,10.3,47108,0.3,20.6,19137,19181,249401,0
2006,40,194498,301966,6646544,6584896,41267,13.8,32860,11,1025913,398905,627008,6.1,15.6,897051,297747,599304,4.5,13.6,128862,2,27.2,19598,19647,134903,0
2006,50,341834,463391,7013901,6969876,42859,9.3,38583,8.4,1003271,333743,669528,4.8,14.4,914486,333035,581451,4.8,13.1,88785,1.3,26.2,25308,25398,183144,0
2006,52,971028,1485153,25470630,25080293,169590,11.5,150088,10.2,4092482,1896033,2196449,7.6,16.3,3289090,1147328,2141762,4.6,13.1,803392,3.2,26.2,111061,111482,769587,0
2006,60,484296,745935,8692612,8545120,104291,14.3,72441,9.9,1594767,702856,891911,8.2,18.7,1292293,538771,753522,6.3,15.1,302474,3.6,30.2,38905,39034,210626,0
2006,70,2291672,2720322,47173993,46120533,346345,12.9,259382,9.7,7811425,2826541,4984884,6.1,16.9,5661339,2038704,3622635,4.4,12.3,2150086,4.6,24.6,174151,174790,1.26E6,0
2007,07,118357,122188,1137883,1134078,17416,14.5,14562,12.1,233550,83747,149803,7.4,20.6,228891,73905,154986,6.5,20.2,4659,0.4,40.4,8348,8353,41874,0
2007,10,19429,24818,689954,615281,3258,13.5,2128,8.8,232946,65321,167625,10.6,37.9,83425,36222,47203,5.9,13.6,149521,24.3,27.2,1152,1158,16825,0
2007,15,512969,520639,6113347,6227339,49316,9.4,62833,11.9,1038397,217630,820767,3.5,16.7,1271501,319353,952148,5.1,20.4,-233104,-3.7,33.4,43519,43557,212580,0
2007,20,267184,322760,14743302,14875814,23720,7.3,26337,8.1,1492941,388463,1104478,2.6,10,1758947,512309,1246638,3.4,11.8,-266006,-1.8,20,17941,18028,222658,0
2007,40,197104,307294,6789998,6705384,42159,13.9,36128,11.9,1162767,451202,711565,6.7,17.3,997832,374202,623630,5.6,14.9,164935,2.4,29.8,19333,19521,113530,0
2007,50,339345,461975,6959706,6974350,40997,8.9,42223,9.1,1056942,337603,719339,4.8,15.2,1086403,383146,703257,5.5,15.6,-29461,-0.4,30.4,24243,24712,150458,0
2007,52,978396,1508978,25605547,25480922,182052,12.2,155765,10.4,4240633,1903602,2337031,7.5,16.6,4002753,1272986,2729767,5,15.7,237880,0.9,31.4,103826,105799,726161,0
2007,60,488923,764110,8679926,8657014,102594,13.6,81650,10.8,1626832,697666,929166,8.1,18.8,1589040,613270,975770,7.1,18.4,37792,0.4,36.8,42530,43134,193022,0
2007,70,2348708,2788054,48183481,47612259,337738,12.3,274210,10,7950198,2659580,5290618,5.6,16.7,6850519,2323833,4526686,4.9,14.4,1099679,2.3,28.8,172445,174176,1.12E6,0
2008,07,119979,123912,1155147,1145090,16962,13.8,15679,12.7,235954,94878,141076,8.3,20.6,217229,81073,136156,7.1,19,18725,1.6,38,9191,9193,44258,0
2008,10,19828,25585,626956,656984,2993,11.9,2124,8.4,115261,40532,74729,6.2,17.5,175645,30963,144682,4.7,26.7,-60384,-9.2,35,1441,1442,15885,0
2008,15,486574,494322,5816218,5961529,41570,8.2,69300,13.7,945531,193274,752257,3.2,15.9,1243165,295493,947672,5,20.9,-297634,-5,31.8,47893,47899,212296,0
2008,20,261257,316117,14371829,14509073,20774,6.5,26220,8.2,1348578,350208,998370,2.4,9.3,1631211,418107,1213104,2.9,11.2,-282633,-1.9,18.6,19277,19327,221057,0
2008,40,194273,304857,6782335,6764885,35852,11.8,35428,11.6,926222,298481,627741,4.4,13.7,894859,266239,628620,3.9,13.2,31363,0.5,26.4,21214,21267,121660,0
2008,50,333260,455870,6908622,6909163,35045,7.7,37953,8.3,935439,286192,649247,4.1,13.5,946521,299909,646612,4.3,13.7,-11082,-0.2,27,25425,25510,164924,0
2008,52,971989,1505977,25782147,25575800,151646,10.1,141300,9.4,3833167,1591472,2241695,6.2,15,3449817,1075482,2374335,4.2,13.5,383350,1.5,27,109029,109299,767769,0
2008,60,470457,750097,8526967,8551332,80120,10.6,86648,11.5,1362248,565255,796993,6.6,15.9,1416212,505462,910750,5.9,16.6,-53964,-0.7,31.8,52787,52927,245780,0
2008,70,2361972,2806636,48962718,48448671,301602,10.8,274847,9.9,7335270,2485532,4849738,5.1,15.1,6344740,2100633,4244107,4.3,13.1,990530,2,26.2,190454,190731,1.26E6,0
2009,07,117239,121388,1121646,1137876,13971,11.4,17864,14.6,221429,87998,133431,7.7,19.5,259062,88115,170947,7.7,22.8,-37633,-3.3,39,9399,9399,50957,0
2009,10,19861,25760,621244,623312,2723,10.6,2614,10.2,103787,35484,68303,5.7,16.7,109685,31004,78681,5,17.6,-5898,-0.9,33.4,1566,1566,14240,0
2009,15,435194,442748,4873085,5339829,30920,6.6,86603,18.5,591165,137154,454011,2.6,11.1,1540318,333750,1206568,6.3,28.8,-949153,-17.7,22.2,53785,53794,218519,0
2009,20,249491,302167,12846222,13554119,17244,5.6,30938,10,971606,292432,679174,2.2,7.2,2400985,512055,1888930,3.8,17.7,-1429379,-10.5,14.4,20631,20661,228876,0
2009,40,185777,295427,6431984,6587416,30670,10.3,40070,13.4,725451,285768,439683,4.3,11,1045821,291786,754035,4.4,15.9,-320370,-4.9,22,21990,22156,120963,0
2009,50,320501,443109,6512594,6696187,30754,6.9,43479,9.7,705981,235019,470962,3.5,10.5,1089157,314210,774947,4.7,16.3,-383176,-5.8,21,27111,27156,154782,0
2009,52,947967,1478110,24522057,25024846,134114,9,154818,10.4,2919996,1382887,1537109,5.5,11.7,3971719,1148586,2823133,4.6,15.9,-1051723,-4.2,23.4,111158,112090,754105,0
2009,60,444097,719289,8109144,8291540,64195,8.8,93598,12.8,1074736,438403,636333,5.3,13,1455040,502388,952652,6.1,17.5,-380304,-4.5,26,51361,52137,214468,0
2009,70,2322972,2763066,47353900,48049482,259961,9.4,316874,11.4,5835244,1907791,3927453,4,12.1,7326698,2140809,5185889,4.5,15.2,-1491454,-3.1,24.2,200256,200593,1.17E6,0
2010,07,117130,121369,1094204,1107670,15383,12.7,15353,12.7,212944,81214,131730,7.3,19.2,239876,73388,166488,6.6,21.7,-26932,-2.5,38.4,8225,8225,37811,0
2010,10,19344,25413,599371,608916,2497,9.8,2741,10.7,95750,36003,59747,5.9,15.7,114840,33036,81804,5.4,18.9,-19090,-3.2,31.4,1665,1665,17978,0
2010,15,401412,408863,4340980,4604013,37774,8.9,71442,16.8,659015,159318,499697,3.5,14.3,1185080,282154,902926,6.1,25.7,-526065,-11.4,28.6,43532,43538,188958,0
2010,20,239631,290438,11990580,12364948,18086,6.1,28010,9.5,973986,254035,719951,2.1,7.9,1722723,439113,1283610,3.6,13.9,-748737,-6,15.8,19353,19398,205148,0
2010,40,181152,289619,6213516,6307480,30742,10.6,34199,11.7,711613,262467,449146,4.2,11.3,899542,299914,599628,4.8,14.3,-187929,-3,22.6,19095,19144,115896,0
2010,50,312910,434927,6259205,6370669,33361,7.6,38825,8.9,713006,251394,461612,3.9,11.2,935934,263098,672836,4.1,14.7,-222928,-3.5,22.4,24578,24676,139668,0
2010,52,943382,1469857,24083602,24209058,138050,9.4,134539,9.2,2839683,1285101,1554582,5.3,11.7,3090594,961221,2129373,4,12.8,-250911,-1.1,23.4,95559,96249,662297,0
2010,60,437272,706253,7792542,7924206,69152,9.7,75500,10.6,1088020,432505,655515,5.5,13.7,1351349,450599,900750,5.7,17.1,-263329,-3.4,27.4,39315,39435,165468,0
2010,70,2312315,2757231,47335902,47216149,290751,10.6,285565,10.4,6346104,2320950,4025154,4.9,13.4,6106599,1907000,4199599,4,12.9,239505,0.5,25.8,183772,184102,1.15E6,0
2011,07,117425,121911,1091504,1092587,15815,13,15228,12.5,200908,75247,125661,6.9,18.4,203074,70289,132785,6.4,18.6,-2166,-0.2,36.8,9542,9543,42675,0
2011,10,19654,25902,658437,627860,2907,11.3,2329,9.1,138288,41325,96963,6.6,22,77133,23888,53245,3.8,12.3,61155,9.7,24.6,1647,1663,15293,0
2011,15,378967,386662,4146276,4241471,38630,9.7,60646,15.3,719621,164138,555483,3.9,17,910011,242687,667324,5.7,21.5,-190390,-4.5,34,41627,41653,177799,0
2011,20,234938,284941,12085316,12009868,19259,6.7,23618,8.2,1235919,293067,942852,2.4,10.3,1085023,356803,728220,3,9,150896,1.3,18,17936,18148,209585,0
2011,40,183044,292447,6333911,6259277,36929,12.8,30896,10.7,828089,314163,513926,5,13.2,678820,223977,454843,3.6,10.8,149269,2.4,21.6,19389,19464,106222,0
2011,50,308407,431392,6356513,6296835,33307,7.7,35058,8.1,830930,248735,582195,4,13.2,711573,228764,482809,3.6,11.3,119357,1.9,22.6,24665,24896,144865,0
2011,52,944442,1476366,24567042,24270219,144652,9.8,130009,8.8,3244225,1360897,1883328,5.6,13.4,2650579,900388,1750191,3.7,10.9,593646,2.5,21.8,101741,102888,670786,0
2011,60,430708,700663,7850643,7805049,67628,9.6,68651,9.8,1115662,455734,659928,5.8,14.3,1024473,370788,653685,4.8,13.1,91189,1.2,26.2,40737,41194,173910,0
2011,70,2318594,2764806,48552239,47842764,292952,10.6,273244,9.9,6935428,2195352,4740076,4.6,14.5,5516477,1768782,3747695,3.7,11.5,1418951,3,23,198558,199443,1.21E6,0
