year2,fsize,Firms,Estabs,Emp,Denom,Estabs_Entry,Estabs_Entry_Rate,Estabs_Exit,Estabs_Exit_Rate,Job_Creation,Job_Creation_Births,Job_Creation_Continuers,Job_Creation_Rate_Births,Job_Creation_Rate,Job_Destruction,Job_Destruction_Deaths,Job_Destruction_Continuers,Job_Destruction_Rate_Deaths,Job_Destruction_Rate,Net_Job_Creation,Net_Job_Creation_Rate,Reallocation_Rate,d_flag,firmdeath_firms,firmdeath_estabs,firmdeath_emp,sic1
1977,a) 1 to 4,2024202,2031989,4491449,4359564,480211,24.1,391695,19.6,1696527,1192853,503674,27.4,38.9,1405657,958079,447578,22,32.2,290870,6.7,64.4,0,296852,297319,750892,
1977,b) 5 to 9,686095,708922,4663313,4553654,67332,9.6,45322,6.5,1250392,627262,623130,13.8,27.5,1024242,510823,513419,11.2,22.5,226150,5,45,0,31824,32378,391447,
1977,c) 10 to 19,381168,418898,5342432,5223475,40573,9.9,23781,5.8,1261871,579469,682402,11.1,24.2,1018165,488425,529740,9.4,19.5,243706,4.7,39,0,13830,14288,360837,
1977,d) 20 to 49,220470,281991,6900839,6751758,29488,10.7,15545,5.7,1511718,638146,873572,9.5,22.4,1206783,542090,664693,8,17.9,304935,4.5,35.8,0,6577,7021,379401,
1977,e) 50 to 99,67177,117373,4751138,4634437,13374,11.8,6244,5.5,959394,382789,576605,8.3,20.7,726928,294115,432813,6.3,15.7,232466,5,31.4,0,1391,1595,186838,
1977,f) 100 to 249,33369,99892,5151711,5027742,12538,13,5781,6,1007246,403017,604229,8,20,762826,293296,469530,5.8,15.2,244420,4.8,30.4,0,539,673,158716,
1977,g) 250 to 499,9354,57341,3219822,3089080,7238,13.1,3389,6.1,607045,236970,370075,7.7,19.7,349541,78226,271315,2.5,11.3,257504,8.4,22.6,1,1,3,,
1977,h) 500 to 999,4696,50027,3183784,3069974,5083,10.3,3807,7.7,559334,192586,366748,6.3,18.2,338435,85425,253010,2.8,11,220899,7.2,22,1,2,15,,
1977,i) 1000 to 2499,2881,66962,4189941,4052207,8084,12.4,4699,7.2,704710,237618,467092,5.9,17.4,434836,102842,331994,2.5,10.7,269874,6.7,21.4,0,,,,
1977,j) 2500 to 4999,1149,58005,3373308,3235628,5996,10.6,3722,6.6,613446,183116,430330,5.7,19,345159,80680,264479,2.5,10.7,268287,8.3,21.4,0,,,,
1977,k) 5000 to 9999,685,48574,3786892,3556954,5001,10.5,3473,7.3,857683,265164,592519,7.5,24.1,420516,80967,339549,2.3,11.8,437167,12.3,23.6,0,,,,
1977,l) 10000+,727,213797,17039609,16419273,22824,10.8,18550,8.8,2892367,921078,1971289,5.6,17.6,1677967,394386,1283581,2.4,10.2,1214400,7.4,20.4,0,,,,
1978,a) 1 to 4,1998093,2001858,4607930,4404590,479591,24.2,426031,21.5,1856389,1227364,629025,27.9,42.1,1430427,1058252,372175,24,32.5,425962,9.6,65,0,314555,314822,787070,
1978,b) 5 to 9,709996,726283,4952509,4713780,51841,7.2,43586,6,1432386,603299,829087,12.8,30.4,945426,497401,448025,10.6,20.1,486960,10.3,40.2,0,29405,29864,357764,
1978,c) 10 to 19,399731,438038,5721971,5466821,20746,4.7,19163,4.4,1386583,450584,935999,8.2,25.4,866534,405912,460622,7.4,15.9,520049,9.5,31.8,0,10749,11150,276889,
1978,d) 20 to 49,235714,303097,7531719,7199197,11576,3.8,11714,3.9,1639500,419167,1220333,5.8,22.8,965172,421089,544083,5.8,13.4,674328,9.4,26.8,0,4490,5000,257459,
1978,e) 50 to 99,72181,128432,5211622,5004252,7877,6.2,7004,5.5,1055684,228315,827369,4.6,21.1,636440,265575,370865,5.3,12.7,419244,8.4,25.4,0,957,1270,128347,
1978,f) 100 to 249,36253,109112,5681642,5475760,9908,9.2,7038,6.5,1130640,261024,869616,4.8,20.6,716058,285291,430767,5.2,13.1,414582,7.5,26.2,0,393,579,115109,
1978,g) 250 to 499,9960,61071,3520091,3395714,6068,10.1,4376,7.3,700260,172612,527648,5.1,20.6,450894,166957,283937,4.9,13.3,249366,7.3,26.6,0,60,111,42478,
1978,h) 500 to 999,4879,54349,3427985,3318205,5358,10,3455,6.5,650285,153316,496969,4.6,19.6,429775,166290,263485,5,13,220510,6.6,26,0,35,67,50023,
1978,i) 1000 to 2499,2980,67518,4418741,4297176,6017,9,4887,7.3,784898,177795,607103,4.1,18.3,541935,194880,347055,4.5,12.6,242963,5.7,25.2,0,13,18,43554,
1978,j) 2500 to 4999,1107,58141,3417132,3361577,5115,8.9,3879,6.7,592198,162753,429445,4.8,17.6,480230,146009,334221,4.3,14.3,111968,3.3,28.6,1,2,2,,
1978,k) 5000 to 9999,677,50543,3512953,3583364,4335,8.7,2925,5.9,506356,124570,381786,3.5,14.1,647041,142858,504183,4,18.1,-140685,-4,28.2,1,1,1,,
1978,l) 10000+,722,224302,17668502,17638286,18471,8.3,14914,6.7,2330095,578737,1751358,3.3,13.2,2281180,533132,1748048,3,12.9,48915,0.3,25.8,1,2,2,,
1979,a) 1 to 4,2007935,2012641,4625688,4415138,474302,24.2,357769,18.2,1811781,1256076,555705,28.4,41,1361777,895109,466668,20.3,30.8,450004,10.2,61.6,0,255159,255315,641613,
1979,b) 5 to 9,759379,775545,5211354,4992278,58610,7.7,38695,5.1,1472794,675245,797549,13.5,29.5,1026096,429205,596891,8.6,20.6,446698,8.9,41.2,0,24636,24868,298832,
1979,c) 10 to 19,432997,468988,6097160,5864509,23559,5.1,17478,3.8,1419910,503917,915993,8.6,24.2,950647,343078,607569,5.9,16.2,469263,8,32.4,0,8696,8928,222877,
1979,d) 20 to 49,258717,325011,8139938,7845569,14572,4.5,11658,3.6,1692894,469031,1223863,6,21.6,1101385,369511,731874,4.7,14,591509,7.6,28,0,3623,4063,208132,
1979,e) 50 to 99,79266,136705,5669419,5485712,9283,6.9,6780,5,1107786,257789,849997,4.7,20.2,738785,256982,481803,4.7,13.5,369001,6.7,27,0,890,1083,119167,
1979,f) 100 to 249,39804,115150,6246206,6005797,9661,8.5,6454,5.7,1246380,291827,954553,4.9,20.8,763577,245602,517975,4.1,12.7,482803,8.1,25.4,0,291,500,82951,
1979,g) 250 to 499,10881,64206,3794551,3687599,5761,9.1,4144,6.5,686058,167483,518575,4.5,18.6,471062,139454,331608,3.8,12.8,214996,5.8,25.6,0,45,136,30134,
1979,h) 500 to 999,5190,56011,3561960,3501203,5605,10.2,3412,6.2,577213,164198,413015,4.7,16.5,454706,115920,338786,3.3,13,122507,3.5,26,0,19,150,26835,
1979,i) 1000 to 2499,3102,72591,4529540,4482145,7006,9.8,4152,5.8,665384,184443,480941,4.1,14.8,570136,150365,419771,3.4,12.7,95248,2.1,25.4,0,8,18,25986,
1979,j) 2500 to 4999,1113,53687,3400579,3333370,5292,10.1,3121,5.9,543694,140648,403046,4.2,16.3,407924,122963,284961,3.7,12.2,135770,4.1,24.4,1,2,2,,
1979,k) 5000 to 9999,690,59097,3857045,3772399,6538,11.3,3898,6.7,602054,176213,425841,4.7,16,431785,109924,321861,2.9,11.4,170269,4.6,22.8,0,,,,
1979,l) 10000+,756,236782,18888676,18476021,21605,9.3,14340,6.1,2617045,709136,1907909,3.8,14.2,1789688,460614,1329074,2.5,9.7,827357,4.5,19.4,0,,,,
1980,a) 1 to 4,1997968,2002972,4476042,4491540,434501,21.7,397875,19.9,1588853,1136729,452124,25.3,35.4,1547826,999923,547903,22.3,34.5,41027,0.9,69,0,318651,318926,811763,
1980,b) 5 to 9,762686,778775,5026187,5077563,51011,6.6,46108,5.9,1208268,581991,626277,11.5,23.8,1270601,517114,753487,10.2,25,-62333,-1.2,47.6,0,34044,34393,414715,
1980,c) 10 to 19,438718,473229,5945870,5993437,20609,4.3,20821,4.4,1159320,438752,720568,7.3,19.3,1225243,424830,800413,7.1,20.4,-65923,-1.1,38.6,0,12554,12885,322301,
1980,d) 20 to 49,264541,328426,8035857,8063920,12967,3.9,12947,3.9,1384150,425937,958213,5.3,17.2,1419255,424955,994300,5.3,17.6,-35105,-0.4,34.4,0,5059,5547,289960,
1980,e) 50 to 99,81265,137603,5629474,5629320,7107,5.2,6445,4.7,892928,225993,666935,4,15.9,881946,246491,635455,4.4,15.7,10982,0.2,31.4,0,988,1214,130298,
1980,f) 100 to 249,41190,117893,6292860,6233923,8009,6.8,6342,5.4,992475,245350,747125,3.9,15.9,866842,237727,629115,3.8,13.9,125633,2,27.8,0,316,566,92512,
1980,g) 250 to 499,11703,66976,4035346,3987063,5600,8.4,4256,6.4,629592,158505,471087,4,15.8,531654,148750,382904,3.7,13.3,97938,2.5,26.6,0,49,168,34632,
1980,h) 500 to 999,5231,56541,3575227,3526978,4669,8.3,3646,6.5,526134,133804,392330,3.8,14.9,429617,119395,310222,3.4,12.2,96517,2.7,24.4,0,15,31,21038,
1980,i) 1000 to 2499,3206,72037,4703537,4608491,6873,9.7,4352,6.1,686222,177300,508922,3.8,14.9,494338,137845,356493,3,10.7,191884,4.2,21.4,0,5,6,14626,
1980,j) 2500 to 4999,1156,58262,3489899,3446989,5634,9.8,3808,6.6,507595,160348,347247,4.7,14.7,422418,114416,308002,3.3,12.3,85177,2.4,24.6,0,,,,
1980,k) 5000 to 9999,689,58203,3905396,3836941,4811,8.4,2913,5.1,545716,156003,389713,4.1,14.2,408848,98538,310310,2.6,10.7,136868,3.5,21.4,0,,,,
1980,l) 10000+,811,247661,19640589,19501983,18310,7.4,14860,6,2600825,729894,1870931,3.7,13.3,2292862,478505,1814357,2.5,11.8,307963,1.5,23.6,0,,,,
1981,a) 1 to 4,1989721,1993023,4508049,4519825,420171,20.9,437645,21.8,1582091,1119022,463069,24.8,35,1603130,1102771,500359,24.4,35.5,-21039,-0.5,70,0,315075,315316,791205,
1981,b) 5 to 9,753199,765884,5042745,5038828,51762,6.7,56922,7.4,1239528,596190,643338,11.8,24.6,1254736,596102,658634,11.8,24.9,-15208,-0.3,49.2,0,31872,32233,388465,
1981,c) 10 to 19,430795,458466,5913281,5928257,22060,4.8,31925,6.9,1202572,489459,713113,8.3,20.3,1256053,548956,707097,9.3,21.2,-53481,-0.9,40.6,0,12344,12658,317778,
1981,d) 20 to 49,256638,308273,7833587,7856431,12655,4,22869,7.3,1411027,523282,887745,6.7,18,1479334,591610,887724,7.5,18.8,-68307,-0.8,36,0,5194,5708,296175,
1981,e) 50 to 99,76777,129707,5351804,5341669,8889,6.9,8507,6.6,924107,337218,586889,6.3,17.3,912459,326075,586384,6.1,17.1,11648,0.2,34.2,0,1043,1455,142024,
1981,f) 100 to 249,38471,115584,5842567,5829719,10113,8.8,9121,7.9,994458,366869,627589,6.3,17.1,977548,363658,613890,6.2,16.8,16910,0.3,33.6,0,379,571,109245,
1981,g) 250 to 499,10944,66180,3741107,3739109,6550,10,5073,7.8,598401,212145,386256,5.7,16,593980,200394,393586,5.4,15.9,4421,0.1,31.8,0,68,120,46287,
1981,h) 500 to 999,5189,56507,3488461,3472621,5460,9.8,4020,7.2,526501,184799,341702,5.3,15.2,493267,165488,327779,4.8,14.2,33234,1,28.4,0,20,231,27979,
1981,i) 1000 to 2499,3285,70986,4695390,4661028,6869,9.8,5154,7.3,662320,250105,412215,5.4,14.2,592617,172143,420474,3.7,12.7,69703,1.5,25.4,0,3,3,11137,
1981,j) 2500 to 4999,1224,61698,3573193,3578635,5879,9.6,5154,8.4,481820,168769,313051,4.7,13.5,490244,144754,345490,4,13.7,-8424,-0.2,27,1,1,12,,
1981,k) 5000 to 9999,725,61358,3746445,3751806,5726,9.5,4151,6.9,527348,170371,356977,4.5,14.1,538891,162472,376419,4.3,14.4,-11543,-0.3,28.2,1,1,2,,
1981,l) 10000+,882,253274,19806239,19848542,21386,8.5,18709,7.4,2613335,797214,1816121,4,13.2,2695052,661283,2033769,3.3,13.6,-81717,-0.4,26.4,0,,,,
1982,a) 1 to 4,2005071,2013160,4622201,4521757,470348,23.6,386903,19.4,1761714,1246382,515332,27.6,39,1484137,971942,512195,21.5,32.8,277577,6.2,65.6,0,247055,247065,633893,
1982,b) 5 to 9,777313,797845,5161180,5114396,65286,8.3,40275,5.1,1319821,669666,650155,13.1,25.8,1215121,481524,733597,9.4,23.8,104700,2,47.6,0,26439,26455,323304,
1982,c) 10 to 19,439413,477747,5970614,5937819,34501,7.4,17162,3.7,1281705,599071,682634,10.1,21.6,1210092,413355,796737,7,20.4,71613,1.2,40.8,0,10437,10506,269485,
1982,d) 20 to 49,260912,328893,7932928,7883843,26763,8.3,10164,3.2,1549443,696338,853105,8.8,19.7,1448292,450628,997664,5.7,18.4,101151,1.3,36.8,0,4749,5021,274629,
1982,e) 50 to 99,78050,135809,5356944,5320546,11868,8.9,5523,4.2,974372,403948,570424,7.6,18.3,900845,249411,651434,4.7,16.9,73527,1.4,33.8,0,951,1110,127209,
1982,f) 100 to 249,39477,121846,5904577,5865651,11350,9.5,6021,5.1,1039712,414784,624928,7.1,17.7,959542,246811,712731,4.2,16.4,80170,1.3,32.8,0,343,441,98246,
1982,g) 250 to 499,11420,69110,3818435,3783898,7041,10.5,3523,5.2,638857,224315,414542,5.9,16.9,568361,127145,441216,3.4,15,70496,1.9,30,0,42,59,27748,
1982,h) 500 to 999,5359,59294,3533413,3475413,6209,10.7,3157,5.5,556730,208580,348150,6,16,444173,102907,341266,3,12.8,112557,3.2,25.6,0,10,12,14979,
1982,i) 1000 to 2499,3504,76691,4881251,4836540,7296,9.6,5563,7.3,682537,241123,441414,5,14.1,591081,151485,439596,3.1,12.2,91456,1.9,24.4,0,7,14,21309,
1982,j) 2500 to 4999,1307,59335,3698381,3671121,5479,9.4,3275,5.6,542243,199160,343083,5.4,14.8,494240,117795,376445,3.2,13.5,48003,1.3,27,0,,,,
1982,k) 5000 to 9999,780,63892,3827886,3785045,5770,9.1,4400,7,590710,241654,349056,6.4,15.6,503324,130504,372820,3.4,13.3,87386,2.3,26.6,0,,,,
1982,l) 10000+,960,267037,19766678,19830826,28348,10.8,19277,7.3,2781024,1108549,1672475,5.6,14,2896328,610005,2286323,3.1,14.6,-115304,-0.6,28,0,,,,
1983,a) 1 to 4,2070559,2076131,4683756,4589679,426714,21,379528,18.6,1599375,1108558,490817,24.2,34.8,1461078,974007,487071,21.2,31.8,138297,3,63.6,0,280275,280484,744526,
1983,b) 5 to 9,784393,804640,5193370,5175982,44071,5.5,41968,5.2,1170484,511259,659225,9.9,22.6,1141445,478305,663140,9.2,22.1,29039,0.5,44.2,0,30493,30773,371552,
1983,c) 10 to 19,437950,479838,5938373,5954325,18267,3.8,19171,4,1110021,407695,702326,6.8,18.6,1144428,405135,739293,6.8,19.2,-34407,-0.6,37.2,0,11765,12058,303235,
1983,d) 20 to 49,257910,329350,7795762,7834290,10681,3.2,11813,3.6,1292750,400762,891988,5.1,16.5,1371593,418774,952819,5.3,17.5,-78843,-1,33,0,4940,5371,282940,
1983,e) 50 to 99,77404,139621,5293179,5330387,7766,5.6,7620,5.5,849493,230619,618874,4.3,15.9,923518,248292,675226,4.7,17.3,-74025,-1.4,31.8,0,983,1375,130690,
1983,f) 100 to 249,38906,123610,5769318,5815755,9563,7.8,8138,6.6,929301,259767,669534,4.5,16,1023328,259814,763514,4.5,17.6,-94027,-1.6,32,0,331,705,96542,
1983,g) 250 to 499,11392,71397,3788231,3816320,6266,8.9,4937,7,610115,179827,430288,4.7,16,667443,143595,523848,3.8,17.5,-57328,-1.5,32,0,34,102,23140,
1983,h) 500 to 999,5410,60219,3486572,3526335,5197,8.7,4457,7.4,506745,141774,364971,4,14.4,585016,135113,449903,3.8,16.6,-78271,-2.2,28.8,0,8,8,11596,
1983,i) 1000 to 2499,3522,75292,4744133,4792271,6661,8.9,6277,8.4,611223,182043,429180,3.8,12.8,708101,172983,535118,3.6,14.8,-96878,-2,25.6,1,1,1,,
1983,j) 2500 to 4999,1337,60848,3637799,3690511,5095,8.4,4276,7.1,508990,190938,318052,5.2,13.8,614920,129217,485703,3.5,16.7,-105930,-2.9,27.6,0,,,,
1983,k) 5000 to 9999,844,66845,3919227,3989027,5174,7.7,5336,8,562528,164361,398167,4.1,14.1,701729,132292,569437,3.3,17.6,-139201,-3.5,28.2,0,,,,
1983,l) 10000+,1069,268907,18471833,19075053,25295,9.4,26030,9.7,2725762,954575,1771187,5,14.3,3932269,1159490,2772779,6.1,20.6,-1206507,-6.3,28.6,0,,,,
1984,a) 1 to 4,2152269,2158080,4978900,4723478,502468,24,378899,18.1,1881234,1308637,572597,27.7,39.8,1381331,939597,441734,19.9,29.2,499903,10.6,58.4,0,267383,267611,682597,
1984,b) 5 to 9,818101,838109,5582486,5369277,52532,6.3,40460,4.9,1442366,608493,833873,11.3,26.9,1016949,449989,566960,8.4,18.9,425417,8,37.8,0,26699,26950,325182,
1984,c) 10 to 19,454960,495348,6400521,6159883,21863,4.4,18506,3.7,1434786,486866,947920,7.9,23.3,953398,374869,578529,6.1,15.5,481388,7.8,31,0,10172,10396,262150,
1984,d) 20 to 49,267851,337614,8477467,8117456,13725,4.1,11322,3.4,1781501,516988,1264513,6.4,21.9,1061435,371143,690292,4.6,13.1,720066,8.8,26.2,0,4142,4489,237136,
1984,e) 50 to 99,80811,142676,5801307,5549951,8546,6,6800,4.8,1171213,301542,869671,5.4,21.1,667997,211172,456825,3.8,12,503216,9.1,24,0,772,1040,103498,
1984,f) 100 to 249,40844,126789,6360490,6100422,9782,7.8,6872,5.5,1254289,337866,916423,5.5,20.6,733713,208267,525446,3.4,12,520576,8.6,24,0,250,422,72568,
1984,g) 250 to 499,11563,72009,4047808,3907436,6133,8.6,4417,6.2,748149,199282,548867,5.1,19.1,467997,119500,348497,3.1,12,280152,7.1,24,0,32,107,21750,
1984,h) 500 to 999,5521,64039,3772224,3660053,5516,8.7,3802,6,653396,180522,472874,4.9,17.9,429140,109724,319416,3,11.7,224256,6.2,23.4,0,12,77,16642,
1984,i) 1000 to 2499,3570,78067,5045736,4928433,7115,9.2,5068,6.6,771002,212834,558168,4.3,15.6,536754,145275,391479,2.9,10.9,234248,4.7,21.8,0,5,5,14843,
1984,j) 2500 to 4999,1332,59614,3779329,3682219,4999,8.5,3734,6.3,617289,220550,396739,6,16.8,423136,115732,307404,3.1,11.5,194153,5.3,23,1,1,1,,
1984,k) 5000 to 9999,830,69795,4034542,3967688,6289,9.2,4038,5.9,617870,183795,434075,4.6,15.6,484279,127680,356599,3.2,12.2,133591,3.4,24.4,1,1,1,,
1984,l) 10000+,954,280574,19107594,18842731,27855,10.1,20347,7.4,2769825,1001467,1768358,5.3,14.7,2269644,650371,1619273,3.5,12,500181,2.7,24,0,,,,
1985,a) 1 to 4,2204179,2210266,5080690,4875076,509173,23.7,390488,18.2,1891280,1317773,573507,27,38.8,1478868,988369,490499,20.3,30.3,412412,8.5,60.6,0,285830,286114,743113,
1985,b) 5 to 9,854118,874372,5763953,5633206,54069,6.2,45448,5.2,1436017,622754,813263,11.1,25.5,1173834,515626,658208,9.2,20.8,262183,4.7,41.6,0,31276,31701,381225,
1985,c) 10 to 19,476784,516399,6622993,6496038,23180,4.5,21168,4.1,1407846,494617,913229,7.6,21.7,1152475,464865,687610,7.2,17.7,255371,4,35.4,0,12650,13007,327487,
1985,d) 20 to 49,284266,354082,8872953,8708358,15476,4.4,13206,3.7,1713548,513655,1199893,5.9,19.7,1384994,528380,856614,6.1,15.9,328554,3.8,31.8,0,5812,6175,334412,
1985,e) 50 to 99,87845,148061,6217897,6107017,6431,4.3,6088,4.1,1090067,268501,821566,4.4,17.8,869269,310614,558655,5.1,14.2,220798,3.6,28.4,0,1237,1535,165820,
1985,f) 100 to 249,45044,132280,6962591,6813263,7298,5.6,5466,4.2,1165761,282579,883182,4.1,17.1,869633,282120,587513,4.1,12.8,296128,4.3,25.6,0,435,784,126308,
1985,g) 250 to 499,12978,74563,4494947,4389292,6651,9,5101,6.9,785832,209332,576500,4.8,17.9,575269,174852,400417,4,13.1,210563,4.8,26.2,0,66,95,45192,
1985,h) 500 to 999,5826,64959,3939124,3870096,6338,9.9,4012,6.3,654113,192296,461817,5,16.9,516617,157986,358631,4.1,13.3,137496,3.6,26.6,0,26,129,34714,
1985,i) 1000 to 2499,3744,81408,5321131,5241126,7973,9.9,5991,7.5,782369,233055,549314,4.4,14.9,623448,192957,430491,3.7,11.9,158921,3,23.8,0,9,131,24901,
1985,j) 2500 to 4999,1337,60593,3766325,3745863,5900,9.9,4058,6.8,562970,166908,396062,4.5,15,522271,180287,341984,4.8,13.9,40699,1.1,27.8,1,2,9,,
1985,k) 5000 to 9999,827,74363,4051040,4073158,5987,8.1,4992,6.8,505705,163631,342074,4,12.4,550516,150924,399592,3.7,13.5,-44811,-1.1,24.8,1,1,2,,
1985,l) 10000+,1015,285716,19800112,19629143,26596,9.3,25480,8.9,2695968,944477,1751491,4.8,13.7,2353318,781615,1571703,4,12,342650,1.7,24,0,,,,
1986,a) 1 to 4,2248997,2255382,5191686,5021408,523657,23.7,416283,18.8,1944625,1372713,571912,27.3,38.7,1571413,1059708,511705,21.1,31.3,373212,7.4,62.6,0,308346,308381,808115,
1986,b) 5 to 9,881466,901694,5960698,5822744,59332,6.6,46795,5.2,1512484,690200,822284,11.9,26,1225448,539739,685709,9.3,21,287036,5,42,0,34367,34407,418745,
1986,c) 10 to 19,495485,534934,6902305,6743768,26357,5,20733,3.9,1514476,588510,925966,8.7,22.5,1190675,461057,729618,6.8,17.7,323801,4.8,35.4,0,13451,13497,347906,
1986,d) 20 to 49,296881,365201,9296049,9070191,16434,4.5,12684,3.5,1876129,657020,1219109,7.2,20.7,1417784,495346,922438,5.5,15.6,458345,5.1,31.2,0,6038,6560,349932,
1986,e) 50 to 99,92182,153010,6529274,6390386,11645,7.7,9075,6,1290479,428286,862193,6.7,20.2,1005892,332552,673340,5.2,15.7,284587,4.5,31.4,0,1333,1770,178169,
1986,f) 100 to 249,46922,134660,7205733,7101581,12439,9.4,8938,6.7,1374700,438724,935976,6.2,19.4,1156522,385904,770618,5.4,16.3,218178,3.1,32.6,0,555,783,163914,
1986,g) 250 to 499,13232,75952,4500143,4452798,7454,10,4951,6.6,764786,238865,525921,5.4,17.2,664521,184798,479723,4.2,14.9,100265,2.3,29.8,0,77,232,51591,
1986,h) 500 to 999,6066,67343,4029958,3998335,6875,10.4,4273,6.5,643170,219284,423886,5.5,16.1,578520,162765,415755,4.1,14.5,64650,1.6,29,0,33,159,41872,
1986,i) 1000 to 2499,3886,84937,5377364,5333596,9044,10.9,5230,6.3,769297,256612,512685,4.8,14.4,679834,162783,517051,3.1,12.7,89463,1.7,25.4,0,5,5,13989,
1986,j) 2500 to 4999,1468,62905,3920160,3895216,6190,10,4265,6.9,590243,211378,378865,5.4,15.2,548865,142886,405979,3.7,14.1,41378,1.1,28.2,0,,,,
1986,k) 5000 to 9999,930,79178,4309155,4203977,6715,8.5,5918,7.5,660589,244976,415613,5.8,15.7,463259,149368,313891,3.6,11,197330,4.7,22,0,,,,
1986,l) 10000+,1081,295266,20248026,20133335,25556,8.7,19890,6.8,2545171,900519,1644652,4.5,12.6,2310187,656567,1653620,3.3,11.5,234984,1.1,23,1,1,1,,
1987,a) 1 to 4,2303913,2310680,5298601,5137071,551060,24.4,421089,18.6,2003677,1418697,584980,27.6,39,1617049,1088663,528386,21.2,31.5,386628,7.5,63,0,325884,326744,860819,
1987,b) 5 to 9,905849,926367,6101739,5993600,68276,7.4,55993,6.1,1571726,719970,851756,12,26.2,1327541,600864,726677,10,22.1,244185,4.1,44.2,0,38022,38818,465436,
1987,c) 10 to 19,511906,551469,7052054,6953031,34667,6.3,30715,5.6,1588982,629425,959557,9.1,22.9,1369492,565716,803776,8.1,19.7,219490,3.2,39.4,0,15868,16554,412202,
1987,d) 20 to 49,306209,381546,9442143,9325366,28308,7.5,22321,5.9,1977794,720484,1257310,7.7,21.2,1735055,647123,1087932,6.9,18.6,242739,2.6,37.2,0,7298,7990,421823,
1987,e) 50 to 99,96128,161987,6696572,6596908,13879,8.7,9070,5.7,1295966,426404,869562,6.5,19.6,1102491,376638,725853,5.7,16.7,193475,2.9,33.4,0,1575,1866,209282,
1987,f) 100 to 249,49411,142503,7549439,7394954,14307,10.3,8601,6.2,1420297,468922,951375,6.3,19.2,1176499,385890,790609,5.2,15.9,243798,3.3,31.8,0,583,903,168007,
1987,g) 250 to 499,14185,81707,4810545,4669743,8976,11.2,6040,7.5,848380,260548,587832,5.6,18.2,669948,209406,460542,4.5,14.3,178432,3.9,28.6,0,73,231,50416,
1987,h) 500 to 999,6451,69273,4127724,4082400,6770,9.9,4644,6.8,655025,196304,458721,4.8,16,558322,175798,382524,4.3,13.7,96703,2.3,27.4,0,29,149,39318,
1987,i) 1000 to 2499,4203,83419,5729119,5712833,7934,9.6,6318,7.7,727150,219499,507651,3.8,12.7,715945,220539,495406,3.9,12.5,11205,0.2,25,0,11,51,29108,
1987,j) 2500 to 4999,1662,71944,4179113,4176459,7533,10.6,5181,7.3,575983,172376,403607,4.1,13.8,565196,187513,377683,4.5,13.5,10787,0.3,27,1,1,1,,
1987,k) 5000 to 9999,1042,84260,4471941,4530281,10399,12.6,6961,8.4,598950,205645,393305,4.5,13.2,710259,260938,449321,5.8,15.7,-111309,-2.5,26.4,0,4,133,41722,
1987,l) 10000+,1125,300300,20194105,20311602,30870,10.3,29147,9.7,2663822,1000686,1663136,4.9,13.1,2898409,1027766,1870643,5.1,14.3,-234587,-1.2,26.2,0,1,2,0,
1988,a) 1 to 4,2280084,2285552,5252555,5160508,488372,21.5,449261,19.8,1872942,1283537,589405,24.9,36.3,1661493,1110194,551299,21.5,32.2,211449,4.1,64.4,0,350745,350746,885998,
1988,b) 5 to 9,916628,936838,6154816,6063901,54731,5.9,48718,5.2,1477997,628875,849122,10.4,24.4,1293425,554561,738864,9.1,21.3,184572,3.1,42.6,0,35926,35926,436707,
1988,c) 10 to 19,520288,564636,7195467,7083200,24578,4.4,22501,4,1488073,525013,963060,7.4,21,1265332,482040,783292,6.8,17.9,222741,3.1,35.8,0,14018,14018,361202,
1988,d) 20 to 49,309674,390621,9607700,9446779,17085,4.4,14644,3.8,1816589,574248,1242341,6.1,19.2,1500189,512500,987689,5.4,15.9,316400,3.3,31.8,0,5808,5812,331786,
1988,e) 50 to 99,95804,166468,6759569,6635135,11664,7.1,8463,5.1,1268845,382256,886589,5.8,19.1,1023952,317925,706027,4.8,15.4,244893,3.7,30.8,0,1098,1108,147389,
1988,f) 100 to 249,49176,148966,7582073,7419252,14462,9.9,9209,6.3,1492059,511155,980904,6.9,20.1,1164797,376604,788193,5.1,15.7,327262,4.4,31.4,0,458,458,136240,
1988,g) 250 to 499,13750,83837,4720090,4611169,8706,10.5,6085,7.4,899640,298751,600889,6.5,19.5,672292,187754,484538,4.1,14.6,227348,4.9,29.2,0,49,49,33610,
1988,h) 500 to 999,6701,74736,4499691,4394410,9018,12.3,5481,7.5,805559,265670,539889,6,18.3,579194,166414,412780,3.8,13.2,226365,5.1,26.4,0,18,22,23653,
1988,i) 1000 to 2499,4347,89172,6129165,5991006,9576,10.9,6629,7.5,973295,320428,652867,5.3,16.2,675196,211187,464009,3.5,11.3,298099,4.9,22.6,0,7,7,18693,
1988,j) 2500 to 4999,1569,75146,4291027,4231396,8716,11.8,6120,8.3,669451,231777,437674,5.5,15.8,531407,172916,358491,4.1,12.6,138044,3.2,25.2,1,2,2,,
1988,k) 5000 to 9999,950,77177,4550919,4536047,7249,9.4,7104,9.2,729834,246678,483156,5.4,16.1,679928,242381,437547,5.3,15,49906,1.1,30,1,1,1,,
1988,l) 10000+,1012,328023,20671839,20488752,46933,14.7,28168,8.8,3051187,1051597,1999590,5.1,14.9,2640912,916300,1724612,4.5,12.9,410275,2,25.8,1,1,1,,
1989,a) 1 to 4,2266893,2272789,5220750,5158080,474885,21,455116,20.1,1827736,1246620,581116,24.2,35.4,1708315,1168853,539462,22.7,33.1,119421,2.3,66.2,0,330810,330875,863017,
1989,b) 5 to 9,925163,945381,6215935,6147980,54220,5.7,54528,5.8,1484500,626267,858233,10.2,24.1,1349675,626254,723421,10.2,22,134825,2.1,44,0,37168,37256,452833,
1989,c) 10 to 19,528339,572442,7316522,7223877,24365,4.3,25287,4.4,1496534,519062,977472,7.2,20.7,1306557,546469,760088,7.6,18.1,189977,2.6,36.2,0,14667,14953,379856,
1989,d) 20 to 49,316555,396592,9863745,9717605,16196,4.1,16052,4,1843483,564401,1279082,5.8,19,1542052,618047,924005,6.4,15.9,301431,3.1,31.8,0,7287,8340,424043,
1989,e) 50 to 99,97407,168462,6893219,6779934,11301,6.8,9025,5.4,1260615,361586,899029,5.3,18.6,1030472,391159,639313,5.8,15.2,230143,3.4,30.4,0,1751,2518,234840,
1989,f) 100 to 249,50707,153231,7822489,7665790,13806,9.2,9537,6.3,1443912,446893,997019,5.8,18.8,1132390,413823,718567,5.4,14.8,311522,4,29.6,0,744,1172,213626,
1989,g) 250 to 499,14519,88437,4974323,4852140,8853,10.3,5090,5.9,862413,253596,608817,5.2,17.8,634680,182880,451800,3.8,13.1,227733,4.7,26.2,0,100,402,59691,
1989,h) 500 to 999,7048,78032,4664272,4561431,8416,11.1,4552,6,750637,241883,508754,5.3,16.5,561551,165178,396373,3.6,12.3,189086,4.2,24.6,0,32,81,37759,
1989,i) 1000 to 2499,4721,94902,6480574,6324720,9470,10.2,5531,6,983628,298427,685201,4.7,15.6,693549,166371,527178,2.6,11,290079,4.6,22,0,16,157,28930,
1989,j) 2500 to 4999,1689,81483,4579183,4486823,8931,11.3,4749,6,676076,233555,442521,5.2,15.1,528562,149015,379547,3.3,11.8,147514,3.3,23.6,0,15,189,19261,
1989,k) 5000 to 9999,1029,88261,4854716,4731682,9202,10.7,5838,6.8,837220,280586,556634,5.9,17.7,608871,163367,445504,3.5,12.9,228349,4.8,25.8,1,12,449,,
1989,l) 10000+,1111,340105,21534187,21232729,38912,11.7,28062,8.4,3114783,1180792,1933991,5.6,14.7,2612005,693764,1918241,3.3,12.3,502778,2.4,24.6,0,16,171,10142,
1990,a) 1 to 4,2317567,2323711,5352962,5193344,510602,22.4,393238,17.3,1932281,1348736,583545,26,37.2,1552816,1009812,543004,19.4,29.9,379465,7.3,59.8,0,312355,312460,823089,
1990,b) 5 to 9,946877,967432,6361400,6249143,59218,6.2,47128,4.9,1542787,682922,859865,10.9,24.7,1294607,538216,756391,8.6,20.7,248180,4,41.4,0,35890,36028,438417,
1990,c) 10 to 19,541695,585849,7486709,7371222,26520,4.5,21329,3.7,1535788,568915,966873,7.7,20.8,1284906,472555,812351,6.4,17.4,250882,3.4,34.8,0,14345,14556,371497,
1990,d) 20 to 49,327254,407130,10121122,9973985,17393,4.3,13296,3.3,1843464,609693,1233771,6.1,18.5,1530101,503725,1026376,5.1,15.3,313363,3.2,30.6,0,6588,7508,379229,
1990,e) 50 to 99,100833,172282,7052234,6971183,10823,6.3,7899,4.6,1197199,370664,826535,5.3,17.2,1025429,311942,713487,4.5,14.7,171770,2.5,29.4,0,1473,2019,198203,
1990,f) 100 to 249,52384,158179,7978693,7884917,13145,8.4,8356,5.4,1322170,419947,902223,5.3,16.8,1122567,328499,794068,4.2,14.2,199603,2.6,28.4,0,569,1004,165273,
1990,g) 250 to 499,14972,90998,5079681,5037952,7579,8.4,5824,6.5,764729,224011,540718,4.4,15.2,681233,186474,494759,3.7,13.5,83496,1.7,27,0,95,277,62181,
1990,h) 500 to 999,7124,80286,4754346,4687019,7406,9.4,4971,6.3,685429,203930,481499,4.4,14.6,558507,134188,424319,2.9,11.9,126922,2.7,23.8,0,17,17,22728,
1990,i) 1000 to 2499,4701,102841,6608924,6567677,9647,9.5,6143,6.1,856150,259095,597055,3.9,13,766976,189711,577265,2.9,11.7,89174,1.3,23.4,0,10,45,28499,
1990,j) 2500 to 4999,1675,81703,4669604,4621731,8025,10,4906,6.1,593965,190525,403440,4.1,12.9,506998,127788,379210,2.8,11,86967,1.9,22,1,2,2,,
1990,k) 5000 to 9999,973,90591,4961876,4920748,7486,8.4,5532,6.2,684004,186823,497181,3.8,13.9,623245,149047,474198,3,12.7,60759,1.2,25.4,1,3,48,,
1990,l) 10000+,1122,351224,22156826,22015808,29563,8.5,24354,7,2710616,814024,1896592,3.7,12.3,2430146,639680,1790466,2.9,11,280470,1.3,22,0,,,,
1991,a) 1 to 4,2357341,2363737,5313032,5272295,472562,20.2,414302,17.8,1754012,1212757,541255,23,33.3,1680599,1051082,629517,19.9,31.9,73413,1.4,63.8,0,306427,306690,809192,
1991,b) 5 to 9,961632,983919,6293827,6333289,54904,5.6,48385,4.9,1365107,599872,765235,9.5,21.6,1450500,550054,900446,8.7,22.9,-85393,-1.3,43.2,0,35779,35969,438233,
1991,c) 10 to 19,548389,597442,7363070,7435587,30167,5.1,23431,3.9,1361381,537217,824164,7.2,18.3,1508372,498966,1009406,6.7,20.3,-146991,-2,36.6,0,15194,15966,396631,
1991,d) 20 to 49,330385,421200,9921222,10047076,30960,7.5,18924,4.6,1741195,669087,1072108,6.7,17.3,1984244,602149,1382095,6,19.7,-243049,-2.4,34.6,0,7622,9039,440086,
1991,e) 50 to 99,100515,178373,6804767,6914303,16646,9.5,9120,5.2,1104565,422871,681694,6.1,16,1315375,369361,946014,5.3,19,-210810,-3,32,0,1777,2583,240922,
1991,f) 100 to 249,51926,161159,7692724,7801350,14920,9.4,9539,6,1198932,459029,739903,5.9,15.4,1397437,392689,1004748,5,17.9,-198505,-2.5,30.8,0,733,1802,212349,
1991,g) 250 to 499,14868,93348,4920828,4972072,8376,9.1,6501,7,714888,245763,469125,4.9,14.4,808151,219191,588960,4.4,16.3,-93263,-1.9,28.8,0,132,760,89094,
1991,h) 500 to 999,7163,78911,4588848,4627557,7273,9.3,6227,7.9,618716,205848,412868,4.4,13.4,695092,192999,502093,4.2,15,-76376,-1.6,26.8,0,42,502,55098,
1991,i) 1000 to 2499,4769,104532,6593525,6573224,9476,9.2,7484,7.2,830130,305494,524636,4.6,12.6,801753,221831,579922,3.4,12.2,28377,0.4,24.4,0,13,36,35211,
1991,j) 2500 to 4999,1740,81308,4612065,4620009,7114,8.8,6036,7.5,560813,177283,383530,3.8,12.1,587908,181688,406220,3.9,12.7,-27095,-0.6,24.2,1,2,219,,
1991,k) 5000 to 9999,1047,93071,4910412,4922864,7965,8.6,6344,6.9,603693,192361,411332,3.9,12.3,635564,171660,463904,3.5,12.9,-31871,-0.6,24.6,1,1,1,,
1991,l) 10000+,1060,365254,22428913,22456198,34449,9.5,27838,7.7,2786133,993492,1792641,4.4,12.4,2870590,715346,2155244,3.2,12.8,-84457,-0.4,24.8,1,1,1,,
1992,a) 1 to 4,2389749,2394406,5386261,5345626,488662,20.5,426802,17.9,1810167,1232890,577277,23.1,33.9,1653831,1067421,586410,20,30.9,156336,3,61.8,0,330908,332843,851980,
1992,b) 5 to 9,959714,979197,6325313,6308886,56243,5.7,52091,5.3,1417838,587936,829902,9.3,22.5,1356719,551084,805635,8.7,21.5,61119,1,43,0,36280,37815,443259,
1992,c) 10 to 19,545730,596378,7375134,7369235,30818,5.2,29241,4.9,1440251,515324,924927,7,19.5,1405258,513813,891445,7,19.1,34993,0.4,38.2,0,15099,16333,392550,
1992,d) 20 to 49,325250,423622,9843547,9817123,25305,6,19920,4.7,1800431,577419,1223012,5.9,18.3,1727649,551918,1175731,5.6,17.6,72782,0.7,35.2,0,6885,8225,395944,
1992,e) 50 to 99,100130,188419,6849580,6805035,13844,7.4,8827,4.7,1209593,364066,845527,5.3,17.8,1109425,324166,785259,4.8,16.3,100168,1.5,32.6,0,1551,2462,209844,
1992,f) 100 to 249,51899,170875,7773114,7724800,12737,7.5,9532,5.6,1340539,397300,943239,5.1,17.4,1240573,363986,876587,4.7,16.1,99966,1.3,32.2,0,670,1207,196043,
1992,g) 250 to 499,15146,98759,5040557,4981590,8486,8.7,6234,6.4,838839,244101,594738,4.9,16.8,720899,184195,536704,3.7,14.5,117940,2.3,29,0,101,766,65675,
1992,h) 500 to 999,7241,81440,4599265,4571509,8243,10.3,5571,7,682967,203522,479445,4.5,14.9,635871,172774,463097,3.8,13.9,47096,1,27.8,0,31,311,42938,
1992,i) 1000 to 2499,4857,107425,6686293,6639029,9001,8.4,8240,7.7,931065,279152,651913,4.2,14,827737,236754,590983,3.6,12.5,103328,1.5,25,0,13,347,40712,
1992,j) 2500 to 4999,1869,82852,4884160,4851852,6729,8.1,7015,8.5,673088,182848,490240,3.8,13.9,607337,170964,436373,3.5,12.5,65751,1.4,25,0,3,3,20499,
1992,k) 5000 to 9999,1039,91864,4954347,4930848,6264,6.8,6303,6.9,667076,206517,460559,4.2,13.5,621271,161264,460007,3.3,12.6,45805,0.9,25.2,0,,,,
1992,l) 10000+,1029,361083,22009343,22239413,28212,7.7,33819,9.3,2693769,953141,1740628,4.3,12.1,3119434,955433,2164001,4.3,14,-425665,-1.9,24.2,1,1,12,,
1993,a) 1 to 4,2436113,2439903,5521006,5396726,491041,20.4,407891,17,1853831,1246350,607481,23.1,34.4,1578771,1007437,571334,18.7,29.3,275060,5.1,58.6,0,324505,325058,825741,
1993,b) 5 to 9,967061,983990,6423347,6350307,47461,4.8,44192,4.5,1424605,557016,867589,8.8,22.4,1271595,497208,774387,7.8,20,153010,2.4,40,0,33829,34343,411265,
1993,c) 10 to 19,546309,596962,7467590,7393573,19764,3.3,21201,3.5,1412913,448630,964283,6.1,19.1,1258294,433994,824300,5.9,17,154619,2.1,34,0,13274,13779,343054,
1993,d) 20 to 49,324464,423527,9937728,9843376,11284,2.7,14136,3.3,1665624,435979,1229645,4.4,16.9,1469254,441893,1027361,4.5,14.9,196370,2,29.8,0,5551,6256,318602,
1993,e) 50 to 99,99344,188636,6948115,6873252,5965,3.1,7755,4.1,1104082,253921,850161,3.7,16.1,952867,276940,675927,4,13.9,151215,2.2,27.8,0,1205,1803,162595,
1993,f) 100 to 249,52218,174405,7979146,7860736,8502,4.9,9608,5.5,1275693,296738,978955,3.8,16.2,1041434,301318,740116,3.8,13.2,234259,3,26.4,0,492,1384,145142,
1993,g) 250 to 499,15206,100024,5183485,5117443,6800,6.8,6992,7,831318,191084,640234,3.7,16.2,700509,175693,524816,3.4,13.7,130809,2.5,27.4,0,63,239,41119,
1993,h) 500 to 999,7114,80539,4724440,4657176,6275,7.8,5702,7.1,711674,187996,523678,4,15.3,579190,158411,420779,3.4,12.4,132484,2.9,24.8,0,19,97,26145,
1993,i) 1000 to 2499,4691,107988,6690384,6651346,8283,7.7,8044,7.5,836235,211975,624260,3.2,12.6,755288,207934,547354,3.1,11.4,80947,1.2,22.8,0,9,16,27968,
1993,j) 2500 to 4999,1761,86363,5010058,4985619,6622,7.7,5841,6.8,594237,155990,438247,3.1,11.9,544953,144583,400370,2.9,10.9,49284,1,21.8,1,1,215,,
1993,k) 5000 to 9999,990,90299,4973892,4957349,5938,6.6,6048,6.7,587075,173145,413930,3.5,11.8,556385,130135,426250,2.6,11.2,30690,0.6,22.4,0,,,,
1993,l) 10000+,1083,357688,22439663,22392202,28826,8,37929,10.5,3038232,951762,2086470,4.3,13.6,2989741,903248,2086493,4,13.4,48491,0.2,26.8,0,1,2,0,
1994,a) 1 to 4,2483658,2488048,5567173,5478525,503893,20.5,416438,17,1870151,1265143,605008,23.1,34.1,1657687,1039922,617765,19,30.3,212464,3.8,60.6,0,328753,329064,840275,
1994,b) 5 to 9,979307,996828,6492038,6437219,50116,5,46116,4.6,1443029,581044,861985,9,22.4,1320134,517629,802505,8,20.5,122895,1.9,41,0,33944,34260,413540,
1994,c) 10 to 19,552106,600334,7550926,7478709,22707,3.8,22250,3.7,1435963,475083,960880,6.4,19.2,1280468,449830,830638,6,17.1,155495,2.1,34.2,0,13349,13776,345490,
1994,d) 20 to 49,329942,427787,10156523,10016943,17301,4.1,14712,3.4,1756457,524142,1232315,5.2,17.5,1464483,464575,999908,4.6,14.6,291974,2.9,29.2,0,5628,6134,321085,
1994,e) 50 to 99,100976,189845,7101606,6988794,8893,4.7,6994,3.7,1156750,323538,833212,4.6,16.6,925627,283148,642479,4.1,13.2,231123,3.4,26.4,0,1234,1664,167073,
1994,f) 100 to 249,53629,175200,8226774,8089343,9406,5.4,7561,4.3,1295881,353026,942855,4.4,16,1013755,317857,695898,3.9,12.5,282126,3.5,25,0,570,1198,168736,
1994,g) 250 to 499,15434,101725,5270484,5179722,7500,7.4,5410,5.4,818416,216162,602254,4.2,15.8,636416,161298,475118,3.1,12.3,182000,3.5,24.6,0,76,227,50021,
1994,h) 500 to 999,7347,82354,4848653,4774250,7459,9.2,5532,6.8,677736,197516,480220,4.1,14.2,525683,140195,385488,2.9,11,152053,3.2,22,0,23,188,29736,
1994,i) 1000 to 2499,4900,110980,6913693,6838183,10285,9.4,7480,6.8,895962,268743,627219,3.9,13.1,739529,209576,529953,3.1,10.8,156433,2.3,21.6,0,19,192,54112,
1994,j) 2500 to 4999,1821,87516,5104212,5060548,7607,8.8,5003,5.8,592398,172414,419984,3.4,11.7,505235,144712,360523,2.9,10,87163,1.7,20,0,4,4,22054,
1994,k) 5000 to 9999,1036,94197,5189493,5157478,8696,9.4,5480,5.9,621104,184630,436474,3.6,12,558597,135829,422768,2.6,10.8,62507,1.2,21.6,1,1,1,,
1994,l) 10000+,1109,372098,22565550,22606452,34776,9.4,30319,8.2,2779375,1036763,1742612,4.6,12.3,2873212,824617,2048595,3.6,12.7,-93837,-0.4,24.6,0,,,,
1995,a) 1 to 4,2542699,2547186,5707961,5561557,522090,20.8,418499,16.7,1937091,1313385,623706,23.6,34.8,1606658,1031231,575427,18.5,28.9,330433,5.9,57.8,0,331957,332480,838743,
1995,b) 5 to 9,984925,1002143,6586659,6474543,51279,5.1,45373,4.5,1478314,597112,881202,9.2,22.8,1239905,510547,729358,7.9,19.2,238409,3.6,38.4,0,34256,34760,416565,
1995,c) 10 to 19,560865,606333,7743674,7597384,22597,3.7,22328,3.7,1486413,490261,996152,6.5,19.6,1182344,445169,737175,5.9,15.6,304069,4,31.2,0,13365,13915,344928,
1995,d) 20 to 49,338812,433867,10525209,10298653,15963,3.7,15298,3.5,1818568,516424,1302144,5,17.7,1356670,467040,889630,4.5,13.2,461898,4.5,26.4,0,5577,6171,321427,
1995,e) 50 to 99,104479,191111,7392180,7235098,8287,4.3,7591,4,1199186,319228,879958,4.4,16.6,881838,297407,584431,4.1,12.2,317348,4.4,24.4,0,1264,1699,168740,
1995,f) 100 to 249,55766,176814,8579667,8378776,10089,5.8,7165,4.1,1366150,372080,994070,4.4,16.3,958737,294019,664718,3.5,11.4,407413,4.9,22.8,0,492,1031,145818,
1995,g) 250 to 499,15984,102850,5505206,5380646,8553,8.4,6093,6,879562,243076,636486,4.5,16.3,630293,169380,460913,3.1,11.7,249269,4.6,23.4,0,78,273,51901,
1995,h) 500 to 999,7542,87937,5068483,4947468,7817,9,4862,5.6,746986,225054,521932,4.5,15.1,500809,127399,373410,2.6,10.1,246177,5,20.2,0,19,19,26290,
1995,i) 1000 to 2499,4969,113364,7075116,6950734,10685,9.6,7258,6.5,930279,287515,642764,4.1,13.4,682449,176509,505940,2.5,9.8,247830,3.6,19.6,0,9,10,23306,
1995,j) 2500 to 4999,1929,93414,5567427,5444374,9075,9.9,5597,6.1,734639,236984,497655,4.4,13.5,493733,121841,371892,2.2,9.1,240906,4.4,18.2,1,1,1,,
1995,k) 5000 to 9999,1105,90831,5168035,5096710,8987,10.1,5770,6.5,691649,245447,446202,4.8,13.6,549173,131797,417376,2.6,10.8,142476,2.8,21.6,0,1,8,0,
1995,l) 10000+,1123,393686,23599965,23354933,37215,9.5,29808,7.6,2971376,1063591,1907785,4.6,12.7,2491587,667858,1823729,2.9,10.7,479789,2,21.4,0,,,,
1996,a) 1 to 4,2578490,2582721,5759447,5641886,519685,20.4,436369,17.1,1917046,1308295,608751,23.2,34,1661109,1075102,586007,19.1,29.4,255937,4.6,58.8,0,343789,343816,870714,
1996,b) 5 to 9,999492,1016192,6652963,6578332,51521,5.1,47135,4.6,1449155,598202,850953,9.1,22,1294761,531886,762875,8.1,19.7,154394,2.3,39.4,0,35732,35755,435720,
1996,c) 10 to 19,572792,616276,7847832,7766953,23093,3.7,22968,3.7,1435013,495261,939752,6.4,18.5,1276814,468265,808549,6,16.4,158199,2.1,32.8,0,14063,14081,363007,
1996,d) 20 to 49,347686,440517,10701477,10594584,16574,3.8,16155,3.7,1725400,530076,1195324,5,16.3,1534151,514288,1019863,4.9,14.5,191249,1.8,29,0,6086,6098,350383,
1996,e) 50 to 99,107764,193614,7524201,7466383,8312,4.3,7589,3.9,1109190,319238,789952,4.3,14.9,1019156,313256,705900,4.2,13.6,90034,1.3,27.2,0,1353,1372,181009,
1996,f) 100 to 249,57077,176452,8680447,8592989,9007,5.1,7042,4,1251430,366581,884849,4.3,14.6,1111487,322713,788774,3.8,12.9,139943,1.7,25.8,0,544,546,157898,
1996,g) 250 to 499,16186,104659,5511319,5431202,8918,8.7,5501,5.3,830353,246822,583531,4.5,15.3,692766,175230,517536,3.2,12.8,137587,2.5,25.6,0,68,69,44429,
1996,h) 500 to 999,7766,88134,5144699,5064956,7954,9.1,5855,6.7,741131,235626,505505,4.7,14.6,598553,159902,438651,3.2,11.8,142578,2.8,23.6,0,20,20,26021,
1996,i) 1000 to 2499,5105,111838,7124046,7043013,10060,9.1,7253,6.6,918921,298090,620831,4.2,13,763396,195043,568353,2.8,10.8,155525,2.2,21.6,0,8,8,20673,
1996,j) 2500 to 4999,2013,97280,5571273,5538000,8977,9.3,7003,7.3,692862,220739,472123,4,12.5,634298,172777,461521,3.1,11.5,58564,1,23,0,,,,
1996,k) 5000 to 9999,1139,102516,5504915,5451586,9672,9.5,7827,7.7,757081,251471,505610,4.6,13.9,656835,194962,461873,3.6,12,100246,1.9,24,1,2,2,,
1996,l) 10000+,1164,403622,24357307,24258967,38867,9.7,33031,8.2,3236784,1204746,2032038,5,13.3,3046668,905642,2141026,3.7,12.6,190116,0.7,25.2,0,,,,
1997,a) 1 to 4,2613495,2616849,5832544,5715248,528037,20.4,448211,17.4,1946847,1320047,626800,23.1,34.1,1686042,1106974,579068,19.4,29.5,260805,4.6,59,0,351797,351797,894043,
1997,b) 5 to 9,1011715,1026651,6739164,6662505,55567,5.4,51815,5.1,1495498,619392,876106,9.3,22.4,1328583,569839,758744,8.6,19.9,166915,2.5,39.8,0,37632,37633,459450,
1997,c) 10 to 19,582944,625478,7972971,7882281,27972,4.5,28110,4.5,1523538,525078,998460,6.7,19.3,1330449,519587,810862,6.6,16.9,193089,2.4,33.8,0,15207,15209,393460,
1997,d) 20 to 49,356246,453047,10962411,10804366,24750,5.5,22205,4.9,1963208,603693,1359515,5.6,18.2,1635038,590749,1044289,5.5,15.1,328170,3.1,30.2,0,6859,6862,396652,
1997,e) 50 to 99,111375,201416,7762144,7622213,15959,8,11780,5.9,1402385,415728,986657,5.5,18.4,1116010,376074,739936,4.9,14.6,286375,3.8,29.2,0,1472,1472,197248,
1997,f) 100 to 249,58990,186513,8997688,8816478,19445,10.6,12194,6.7,1679440,533956,1145484,6.1,19,1308776,429771,879005,4.9,14.8,370664,4.2,29.6,0,606,606,178234,
1997,g) 250 to 499,16730,109598,5717304,5592449,11655,10.9,6650,6.2,983434,298846,684588,5.3,17.6,734964,215680,519284,3.9,13.1,248470,4.5,26.2,0,76,76,50454,
1997,h) 500 to 999,8058,91208,5252236,5204314,9016,10,6610,7.3,792224,221937,570287,4.3,15.2,695655,219360,476295,4.2,13.4,96569,1.8,26.8,0,39,39,55506,
1997,i) 1000 to 2499,5232,118453,7294058,7197430,12271,10.5,10101,8.6,1118687,336684,782003,4.7,15.5,933701,286669,647032,4,13,184986,2.5,26,0,10,10,28391,
1997,j) 2500 to 4999,2024,93509,5571555,5554836,10141,10.9,8832,9.5,810441,268426,542015,4.8,14.6,779259,226851,552408,4.1,14,31182,0.6,28,0,3,3,24928,
1997,k) 5000 to 9999,1188,107908,5638911,5631130,10484,9.7,11148,10.3,800980,276988,523992,4.9,14.2,786635,249029,537606,4.4,14,14345,0.2,28,1,1,1,,
1997,l) 10000+,1126,412585,25462778,25192107,48967,11.9,45392,11,4007600,1454078,2553522,5.8,15.9,3461866,1205279,2256587,4.8,13.7,545734,2.2,27.4,0,,,,
1998,a) 1 to 4,2626766,2629324,5837685,5762795,514461,19.7,459197,17.6,1904595,1293947,610648,22.5,33,1725535,1129525,596010,19.6,29.9,179060,3.1,59.8,0,361696,361696,911594,
1998,b) 5 to 9,1018519,1031448,6784231,6719933,51035,4.9,49317,4.8,1480940,612052,868888,9.1,22,1337741,564541,773200,8.4,19.9,143199,2.1,39.8,0,37463,37463,457237,
1998,c) 10 to 19,588289,628159,8086479,7991702,22270,3.5,23933,3.8,1528248,539655,988593,6.8,19.1,1326220,507756,818464,6.4,16.6,202028,2.5,33.2,0,15124,15124,391052,
1998,d) 20 to 49,360356,452654,11148817,10990854,13840,3,16310,3.6,1902477,598550,1303927,5.4,17.3,1574180,540594,1033586,4.9,14.3,328297,3,28.6,0,6552,6552,377666,
1998,e) 50 to 99,112203,200757,7899317,7776737,6828,3.4,8092,4,1290586,373128,917458,4.8,16.6,1040024,339960,700064,4.4,13.4,250562,3.2,26.8,0,1460,1480,196338,
1998,f) 100 to 249,60017,188659,9198322,9030441,10251,5.5,8937,4.8,1532776,453036,1079740,5,17,1195320,392045,803275,4.3,13.2,337456,3.8,26.4,0,625,625,185791,
1998,g) 250 to 499,16961,111075,5806575,5709942,9937,9.1,7375,6.7,966283,276573,689710,4.8,16.9,772067,235721,536346,4.1,13.5,194216,3.4,27,0,112,112,75839,
1998,h) 500 to 999,8204,96185,5455856,5341047,10704,11.4,6604,7,917480,286033,631447,5.4,17.2,685022,204014,481008,3.8,12.8,232458,4.4,25.6,0,34,34,44635,
1998,i) 1000 to 2499,5245,121307,7355295,7219155,11518,9.7,7534,6.3,1080895,356582,724313,4.9,15,803687,229086,574601,3.2,11.1,277208,3.9,22.2,0,7,7,20674,
1998,j) 2500 to 4999,2020,94112,5733480,5597933,11101,12.1,6403,7,806822,245628,561194,4.4,14.4,543063,147793,395270,2.6,9.7,263759,4.7,19.4,0,,,,
1998,k) 5000 to 9999,1198,118099,6116158,5994920,12770,11,9247,8,956029,312212,643817,5.2,15.9,713047,200496,512551,3.3,11.9,242982,4,23.8,1,1,1,,
1998,l) 10000+,1181,437379,26853516,26591552,51552,11.9,40985,9.5,3656682,1297129,2359553,4.9,13.8,3138695,1032762,2105933,3.9,11.8,517987,2,23.6,0,,,,
1999,a) 1 to 4,2634089,2637353,5833491,5770304,497892,19,457497,17.5,1860785,1246662,614123,21.6,32.2,1715241,1122220,593021,19.4,29.7,145544,2.5,59.4,0,355204,355204,893835,
1999,b) 5 to 9,1022751,1036310,6811766,6756387,49192,4.7,49308,4.8,1459073,585348,873725,8.7,21.6,1337967,573392,764575,8.5,19.8,121106,1.8,39.6,0,37624,37624,459733,
1999,c) 10 to 19,594703,633118,8175376,8093612,21848,3.4,23954,3.8,1495120,506143,988977,6.3,18.5,1320526,523754,796772,6.5,16.3,174594,2.2,32.6,0,15443,15443,399505,
1999,d) 20 to 49,366667,454812,11346367,11209712,14666,3.2,16693,3.7,1852198,573657,1278541,5.1,16.5,1570726,582946,987780,5.2,14,281472,2.5,28,0,6945,6945,399545,
1999,e) 50 to 99,114137,199437,8042107,7943100,7814,3.9,7700,3.9,1230553,367489,863064,4.6,15.5,1028629,376251,652378,4.7,12.9,201924,2.6,25.8,0,1652,1652,222797,
1999,f) 100 to 249,60800,188353,9296027,9157159,12142,6.5,8275,4.4,1442812,449879,992933,4.9,15.8,1159345,386977,772368,4.2,12.7,283467,3.1,25.4,0,649,649,187297,
1999,g) 250 to 499,17595,113850,6039448,5937034,11023,9.9,6905,6.2,982604,324813,657791,5.5,16.6,772470,224238,548232,3.8,13,210134,3.6,26,0,86,86,56158,
1999,h) 500 to 999,8298,96707,5511226,5423947,10534,11,7721,8.1,879528,309817,569711,5.7,16.2,701104,208186,492918,3.8,12.9,178424,3.3,25.8,0,26,26,32281,
1999,i) 1000 to 2499,5390,121944,7644211,7531546,11130,9.2,7749,6.4,1089991,355969,734022,4.7,14.5,863207,253285,609922,3.4,11.5,226784,3,23,0,11,11,29230,
1999,j) 2500 to 4999,2147,98093,5758789,5697330,10317,10.7,6452,6.7,799831,256144,543687,4.5,14,674689,194790,479899,3.4,11.8,125142,2.2,23.6,1,2,2,,
1999,k) 5000 to 9999,1317,116770,6166688,6084754,14506,12.7,9519,8.3,955766,366865,588901,6,15.7,791919,208470,583449,3.4,13,163847,2.7,26,0,,,,
1999,l) 10000+,1251,477874,28440075,28261366,54687,11.6,41546,8.8,4058515,1468821,2589694,5.2,14.4,3735288,1247422,2487866,4.4,13.2,323227,1.2,26.4,0,,,,
2000,a) 1 to 4,2616667,2620485,5822610,5755669,481697,18.4,469761,18,1847182,1229338,617844,21.4,32.1,1717337,1143260,574077,19.9,29.8,129845,2.3,59.6,0,348262,348262,870935,
2000,b) 5 to 9,1026469,1040783,6871917,6778964,50330,4.8,49345,4.7,1494380,592875,901505,8.7,22,1308859,570947,737912,8.4,19.3,185521,2.7,38.6,0,36375,36375,444183,
2000,c) 10 to 19,604787,643195,8355117,8220244,23231,3.6,23398,3.6,1560259,522129,1038130,6.4,19,1292051,510253,781798,6.2,15.7,268208,3.3,31.4,0,14720,14720,380586,
2000,d) 20 to 49,375666,461999,11668143,11457554,16049,3.5,15511,3.4,1951444,586815,1364629,5.1,17,1527865,556044,971821,4.9,13.3,423579,3.7,26.6,0,6486,6486,372251,
2000,e) 50 to 99,117817,201050,8331401,8168438,7309,3.6,6532,3.3,1294506,359618,934888,4.4,15.8,967014,330059,636955,4,11.8,327492,4,23.6,0,1391,1404,187406,
2000,f) 100 to 249,62736,191091,9685191,9453792,12783,6.8,8524,4.5,1594266,470474,1123792,5,16.9,1129458,356668,772790,3.8,11.9,464808,5,23.8,0,568,568,167316,
2000,g) 250 to 499,17956,115816,6203139,6054306,10482,9.2,6904,6.1,1030743,309650,721093,5.1,17,735302,220941,514361,3.6,12.1,295441,4.9,24.2,0,102,102,67306,
2000,h) 500 to 999,8518,97025,5680404,5568250,9616,10.1,6742,7.1,900426,284849,615577,5.1,16.2,675930,208766,467164,3.7,12.1,224496,4.1,24.2,0,26,26,35073,
2000,i) 1000 to 2499,5474,128632,7757362,7611688,14490,11.5,9020,7.2,1194056,411291,782765,5.4,15.7,909355,287689,621666,3.8,11.9,284701,3.8,23.8,0,14,14,45690,
2000,j) 2500 to 4999,2146,96372,5999943,5892878,9486,9.9,7880,8.2,910258,330659,579599,5.6,15.4,696763,201085,495678,3.4,11.8,213495,3.6,23.6,1,2,2,,
2000,k) 5000 to 9999,1317,115297,6203686,6114906,10452,9.1,10898,9.4,985697,328533,657164,5.4,16.1,811740,265061,546679,4.3,13.3,173957,2.8,26.6,0,,,,
2000,l) 10000+,1335,507932,30053434,29750719,60764,12.1,48211,9.6,4550652,1656968,2893684,5.6,15.3,3952868,1418335,2534533,4.8,13.3,597784,2,26.6,1,1,1,,
2001,a) 1 to 4,2669936,2674481,5866920,5833744,497716,18.7,497320,18.7,1825700,1253620,572080,21.5,31.3,1824417,1211609,612808,20.8,31.3,1283,0,62.6,0,345196,345287,869252,
2001,b) 5 to 9,1034745,1050453,6844633,6837893,50328,4.8,51989,5,1404193,583939,820254,8.5,20.5,1419060,604577,814483,8.8,20.8,-14867,-0.3,41,0,36729,36787,448849,
2001,c) 10 to 19,613612,652736,8373580,8346686,23836,3.7,24033,3.7,1447478,511965,935513,6.1,17.3,1421375,535384,885991,6.4,17,26103,0.3,34,0,14976,15060,387945,
2001,d) 20 to 49,383816,469605,11772575,11711799,17286,3.7,15624,3.3,1806433,573878,1232555,4.9,15.4,1717484,578117,1139367,4.9,14.7,88949,0.7,29.4,0,6676,6735,385281,
2001,e) 50 to 99,121150,204506,8448211,8386413,9262,4.6,6910,3.4,1220471,379193,841278,4.5,14.6,1124522,341139,783383,4.1,13.4,95949,1.2,26.8,0,1461,1474,196332,
2001,f) 100 to 249,64638,195182,9813108,9743778,13963,7.2,9288,4.8,1459240,472395,986845,4.8,15,1349615,389925,959690,4,13.9,109625,1.1,27.8,0,586,637,174505,
2001,g) 250 to 499,18443,117730,6261504,6221307,9966,8.6,7414,6.4,913609,290130,623479,4.7,14.7,852460,223299,629161,3.6,13.7,61149,1,27.4,0,78,78,53860,
2001,h) 500 to 999,8859,99899,5867953,5817907,8336,8.4,6622,6.7,859323,273654,585669,4.7,14.8,778576,204623,573953,3.5,13.4,80747,1.4,26.8,0,27,27,37459,
2001,i) 1000 to 2499,5490,126678,7803348,7741008,12447,9.9,9977,8,1143467,386668,756799,5,14.8,1045711,314326,731385,4.1,13.5,97756,1.3,27,0,14,14,42366,
2001,j) 2500 to 4999,2187,102321,6113720,6078308,12302,12.2,8635,8.6,904664,301627,603037,5,14.9,837021,279509,557512,4.6,13.8,67643,1.1,27.6,0,3,3,17044,
2001,k) 5000 to 9999,1271,118934,6471648,6493247,12429,10.5,11815,10,981200,357234,623966,5.5,15.1,1030218,297500,732718,4.6,15.9,-49018,-0.8,30.2,0,,,,
2001,l) 10000+,1421,536785,30712297,30543388,61767,11.7,42155,8,4487338,1691232,2796106,5.5,14.7,4228684,1226318,3002366,4,13.8,258654,0.9,27.6,0,,,,
2002,a) 1 to 4,2705287,2708436,5993825,5901257,559113,20.8,509442,19,2019409,1395266,624143,23.6,34.2,1834272,1209536,624736,20.5,31.1,185137,3.1,62.2,0,340446,340629,853563,
2002,b) 5 to 9,1040129,1052788,6874918,6855646,59333,5.6,54618,5.2,1521558,679608,841950,9.9,22.2,1483013,603457,879556,8.8,21.6,38545,0.6,43.2,0,35994,36159,440848,
2002,c) 10 to 19,616389,652777,8371950,8362407,31787,4.9,30893,4.7,1604023,650931,953092,7.8,19.2,1584937,583177,1001760,7,19,19086,0.2,38,0,15160,15344,391549,
2002,d) 20 to 49,385204,472293,11681605,11713672,26056,5.5,24834,5.3,2043783,806801,1236982,6.9,17.4,2107917,703817,1404100,6,18,-64134,-0.6,34.8,0,6928,7221,401539,
2002,e) 50 to 99,120542,205821,8223985,8276158,15250,7.4,13007,6.4,1415806,588397,827409,7.1,17.1,1520152,480821,1039331,5.8,18.4,-104346,-1.3,34.2,0,1630,1820,218104,
2002,f) 100 to 249,64340,199749,9627026,9656198,16256,8.2,12659,6.4,1664164,699373,964791,7.2,17.2,1722508,503073,1219435,5.2,17.8,-58344,-0.6,34.4,0,669,809,194075,
2002,g) 250 to 499,18402,121312,6045470,6104743,9442,7.8,7960,6.6,889824,310581,579243,5.1,14.6,1008370,247631,760739,4.1,16.5,-118546,-1.9,29.2,0,99,139,64693,
2002,h) 500 to 999,8869,101052,5651162,5735099,8162,8.1,8334,8.2,797826,250176,547650,4.4,13.9,967510,284590,682920,5,16.9,-169684,-3,27.8,0,35,94,49039,
2002,i) 1000 to 2499,5632,125560,7557981,7653651,10394,8.3,11094,8.8,1073033,350871,722162,4.6,14,1249962,392672,857290,5.1,16.3,-176929,-2.3,28,0,19,24,52330,
2002,j) 2500 to 4999,2246,101025,5903291,5994828,9306,9.2,9881,9.8,796349,247151,549198,4.1,13.3,945701,298400,647301,5,15.8,-149352,-2.5,26.6,0,5,26,37608,
2002,k) 5000 to 9999,1287,118008,6180415,6289640,11393,9.7,11506,9.7,880569,308253,572316,4.9,14,1090334,358137,732197,5.7,17.3,-209765,-3.3,28,0,,,,
2002,l) 10000+,1317,540363,30008600,30497355,60676,11.2,63584,11.7,4400786,1754055,2646731,5.8,14.4,5360236,1781779,3578457,5.8,17.6,-959450,-3.2,28.8,0,,,,
2003,a) 1 to 4,2743570,2746390,6067243,5977656,567605,20.9,464430,17.1,2002051,1374493,627558,23,33.5,1727189,1097898,629291,18.4,28.9,274862,4.6,57.8,0,351367,351420,862873,
2003,b) 5 to 9,1043272,1055305,6915697,6862118,50000,4.7,43252,4.1,1475655,591668,883987,8.6,21.5,1331005,512958,818047,7.5,19.4,144650,2.1,38.8,0,35223,35321,430990,
2003,c) 10 to 19,618830,655254,8459223,8385482,22767,3.5,19070,2.9,1534324,511570,1022754,6.1,18.3,1355596,449051,906545,5.4,16.2,178728,2.1,32.4,0,14431,14543,374029,
2003,d) 20 to 49,384850,472451,11850471,11714120,15401,3.3,11293,2.4,1949545,569868,1379677,4.9,16.6,1645802,491689,1154113,4.2,14,303743,2.6,28,0,6683,7042,387697,
2003,e) 50 to 99,119114,206223,8391169,8256474,7528,3.7,4431,2.2,1356463,367391,989072,4.4,16.4,1067524,320141,747383,3.9,12.9,288939,3.5,25.8,0,1738,1890,237369,
2003,f) 100 to 249,64119,201144,9925294,9734083,8754,4.4,4212,2.1,1619008,452897,1166111,4.7,16.6,1216605,380623,835982,3.9,12.5,402403,4.1,25,0,886,1133,261553,
2003,g) 250 to 499,18430,124315,6338264,6221591,9198,7.6,3615,3,1026696,284606,742090,4.6,16.5,784598,177985,606613,2.9,12.6,242098,3.9,25.2,0,96,212,65805,
2003,h) 500 to 999,8493,105751,5699729,5636895,8697,8.4,3939,3.8,855706,271477,584229,4.8,15.2,727150,171349,555801,3,12.9,128556,2.3,25.8,0,39,41,57290,
2003,i) 1000 to 2499,5307,125767,7555687,7505963,10027,8.1,4721,3.8,1033029,329943,703086,4.4,13.8,927692,197450,730242,2.6,12.4,105337,1.4,24.8,0,18,933,50949,
2003,j) 2500 to 4999,2059,104047,5963185,5939674,8545,8.3,5113,5,818841,269606,549235,4.5,13.8,763244,147044,616200,2.5,12.8,55597,1,25.6,1,1,1,,
2003,k) 5000 to 9999,1176,112805,6247784,6240658,9249,8.3,5221,4.7,862178,231942,630236,3.7,13.8,831808,180686,651122,2.9,13.3,30370,0.5,26.6,1,1,1,,
2003,l) 10000+,1344,550967,29303118,29425202,62618,11.6,39643,7.3,3733981,1481963,2252018,5,12.7,3775659,1051399,2724260,3.6,12.8,-41678,-0.1,25.4,1,1,1,,
2004,a) 1 to 4,2785511,2789225,6166737,6045901,567632,20.6,466067,16.9,2005071,1368628,636443,22.6,33.2,1698190,1103816,594374,18.3,28.1,306881,5.1,56.2,0,353403,353442,871184,
2004,b) 5 to 9,1058017,1071252,7044533,6957418,50157,4.7,43405,4.1,1504732,594980,909752,8.6,21.6,1303249,514554,788695,7.4,18.7,201483,2.9,37.4,0,35066,35135,430063,
2004,c) 10 to 19,627673,664846,8606987,8509583,22329,3.4,19865,3,1548077,507435,1040642,6,18.2,1327391,458826,868565,5.4,15.6,220686,2.6,31.2,0,14505,14630,375718,
2004,d) 20 to 49,390272,476899,12003306,11871756,14147,3,11728,2.5,1878697,556768,1321929,4.7,15.8,1588522,497170,1091352,4.2,13.4,290175,2.4,26.8,0,6692,7071,389544,
2004,e) 50 to 99,121683,207652,8522496,8427121,6238,3,5130,2.5,1229963,371762,858201,4.4,14.6,1026197,321368,704829,3.8,12.2,203766,2.4,24.4,0,1719,2023,232297,
2004,f) 100 to 249,65691,200288,10069213,9961699,6879,3.5,4668,2.3,1372726,415931,956795,4.2,13.8,1148785,356883,791902,3.6,11.5,223941,2.3,23,0,819,1100,241397,
2004,g) 250 to 499,19017,125731,6480823,6408983,8158,6.6,4105,3.3,894502,231473,663029,3.6,14,747714,163095,584619,2.5,11.7,146788,2.3,23.4,0,102,411,68610,
2004,h) 500 to 999,8690,103835,5757336,5672946,7484,7.3,3804,3.7,778352,217001,561351,3.8,13.7,612906,142815,470091,2.5,10.8,165446,2.9,21.6,0,29,35,39763,
2004,i) 1000 to 2499,5375,129306,7683430,7608387,10012,7.9,4444,3.5,970454,272683,697771,3.6,12.8,820709,188543,632166,2.5,10.8,149745,2,21.6,0,12,12,35771,
2004,j) 2500 to 4999,2043,104413,5995333,5968192,8744,8.5,5469,5.3,749207,230153,519054,3.9,12.6,693640,183004,510636,3.1,11.6,55567,1,23.2,0,4,4,25577,
2004,k) 5000 to 9999,1213,115187,6505692,6445691,10607,9.4,5599,5,874535,264176,610359,4.1,13.6,754097,200304,553793,3.1,11.7,120438,1.9,23.4,1,2,2,,
2004,l) 10000+,1245,553552,29161989,29115084,57732,10.5,50641,9.2,3933033,1299384,2633649,4.5,13.5,3817637,1276221,2541416,4.4,13.1,115396,0.4,26.2,1,1,1,,
2005,a) 1 to 4,2858522,2862913,6226014,6145959,584686,20.8,471497,16.7,2007922,1397363,610559,22.7,32.7,1799948,1108079,691869,18,29.3,207974,3.4,58.6,0,363264,363340,894587,
2005,b) 5 to 9,1075898,1090444,7091039,7068666,53321,4.9,43705,4,1488020,631996,856024,8.9,21.1,1424042,514179,909863,7.3,20.1,63978,1,40.2,0,36180,36299,443733,
2005,c) 10 to 19,633915,671621,8575706,8586087,23865,3.6,20091,3,1487975,541730,946245,6.3,17.3,1492793,461428,1031365,5.4,17.4,-4818,-0.1,34.6,0,14987,15236,387465,
2005,d) 20 to 49,392771,479707,11968274,11949659,15462,3.2,11841,2.5,1822105,588467,1233638,4.9,15.2,1766950,504499,1262451,4.2,14.8,55155,0.4,29.6,0,6840,7153,398317,
2005,e) 50 to 99,122522,208812,8547453,8497947,8060,3.9,5016,2.4,1205781,373291,832490,4.4,14.2,1097211,329523,767688,3.9,12.9,108570,1.3,25.8,0,1763,2071,239738,
2005,f) 100 to 249,66433,201186,10203257,10073776,9156,4.6,4201,2.1,1435563,444356,991207,4.4,14.3,1174694,370942,803752,3.7,11.7,260869,2.6,23.4,0,859,1004,259397,
2005,g) 250 to 499,19372,129251,6662222,6530114,11541,9.2,3292,2.6,1008383,310681,697702,4.8,15.4,740846,192645,548201,3,11.3,267537,4.1,22.6,0,155,199,108642,
2005,h) 500 to 999,8760,108346,5902928,5794977,9993,9.5,4749,4.5,886680,294309,592371,5.1,15.3,665463,200774,464689,3.5,11.5,221217,3.8,23,0,77,234,107207,
2005,i) 1000 to 2499,5468,124282,7860733,7765267,9830,8,5673,4.6,1047445,343943,703502,4.4,13.5,861271,266661,594610,3.4,11.1,186174,2.4,22.2,0,32,65,95116,
2005,j) 2500 to 4999,2065,112410,6159979,6040923,11170,10.3,3825,3.5,825724,278607,547117,4.6,13.7,583333,157952,425381,2.6,9.7,242391,4,19.4,0,6,6,39372,
2005,k) 5000 to 9999,1191,116610,6360102,6314535,10616,9.3,5272,4.6,813489,275804,537685,4.4,12.9,725352,174782,550570,2.8,11.5,88137,1.4,23,1,2,2,,
2005,l) 10000+,1204,573927,29958680,29713289,63747,11.3,42008,7.5,3851990,1499551,2352439,5,13,3381086,905151,2475935,3,11.4,470904,1.6,22.8,0,1,1,0,
2006,a) 1 to 4,2875632,2880437,6263558,6202409,581532,20.3,529552,18.5,1990826,1377001,613825,22.2,32.1,1828666,1217239,611427,19.6,29.5,162160,2.6,59,0,391995,392093,951493,
2006,b) 5 to 9,1089070,1104986,7274900,7162613,54635,5,46963,4.3,1586686,641510,945176,9,22.2,1349251,554396,794855,7.7,18.8,237435,3.4,37.6,0,38205,38331,467064,
2006,c) 10 to 19,638674,679939,8795553,8653142,28496,4.2,21043,3.1,1620785,577825,1042960,6.7,18.7,1325031,491788,833243,5.7,15.3,295754,3.4,30.6,0,15798,15970,410488,
2006,d) 20 to 49,395482,488116,12259991,12051453,23870,4.9,12669,2.6,2022929,683886,1339043,5.7,16.8,1598864,568926,1029938,4.7,13.3,424065,3.5,26.6,0,7913,8191,464424,
2006,e) 50 to 99,125400,215152,8869801,8684936,13283,6.3,5356,2.5,1440850,482380,958470,5.6,16.6,1067450,396685,670765,4.6,12.3,373400,4.3,24.6,0,2260,2478,308701,
2006,f) 100 to 249,67755,207667,10499989,10284260,14483,7.1,4461,2.2,1623517,579363,1044154,5.6,15.8,1192434,441248,751186,4.3,11.6,431083,4.2,23.2,0,1129,1394,332125,
2006,g) 250 to 499,19690,131390,6761705,6626177,11388,8.9,3637,2.9,1041518,323645,717873,4.9,15.7,768954,194229,574725,2.9,11.6,272564,4.1,23.2,0,163,316,107807,
2006,h) 500 to 999,8959,107643,6061135,5937347,8160,7.8,3454,3.3,862529,244938,617591,4.1,14.5,615177,144556,470621,2.4,10.4,247352,4.1,20.8,0,43,235,56502,
2006,i) 1000 to 2499,5569,131476,8039921,7863603,11552,9,4665,3.6,1076818,317169,759649,4,13.7,724678,158449,566229,2,9.2,352140,4.5,18.4,0,13,13,36992,
2006,j) 2500 to 4999,2164,108241,6297734,6213088,9159,8.6,4881,4.6,798947,245826,553121,4,12.9,631259,147126,484133,2.4,10.2,167688,2.7,20.4,0,4,4,23515,
2006,k) 5000 to 9999,1213,119552,6576101,6458871,11917,10.3,4861,4.2,912970,295046,617924,4.6,14.1,672785,175377,497408,2.7,10.4,240185,3.7,20.8,1,1,1,,
2006,l) 10000+,1266,607068,31214842,30818697,63202,10.6,37605,6.3,4159104,1477724,2681380,4.8,13.5,3356705,863636,2493069,2.8,10.9,802399,2.6,21.8,0,,,,
2007,a) 1 to 4,2913430,2916971,6232482,6198869,551586,19.1,508959,17.6,1878258,1291772,586486,20.8,30.3,1837171,1167421,669750,18.8,29.6,41087,0.7,59.2,0,381686,382858,916023,
2007,b) 5 to 9,1100385,1112606,7235686,7223388,53609,4.8,51791,4.7,1514905,618221,896684,8.6,21,1491568,574280,917288,8,20.6,23337,0.4,41.2,0,38008,38840,465839,
2007,c) 10 to 19,645996,680266,8748930,8726587,27128,4,28516,4.2,1545587,567982,977605,6.5,17.7,1503114,538807,964307,6.2,17.2,42473,0.5,34.4,0,15737,16652,406527,
2007,d) 20 to 49,400322,488561,12194440,12141998,21838,4.5,22942,4.7,1982631,653383,1329248,5.4,16.3,1882197,653892,1228305,5.4,15.5,100434,0.8,31,0,7199,8161,418700,
2007,e) 50 to 99,128457,220967,8833178,8799112,15420,7,12091,5.5,1458633,469045,989588,5.3,16.6,1395520,447000,948520,5.1,15.9,63113,0.7,31.8,0,1738,2308,234258,
2007,f) 100 to 249,69126,214780,10408626,10379214,19952,9.5,12172,5.8,1707238,566469,1140769,5.5,16.4,1645988,516873,1129115,5,15.9,61250,0.5,31.8,0,790,1432,236221,
2007,g) 250 to 499,20288,136595,6802517,6731623,11008,8.3,4165,3.1,987939,281372,706567,4.2,14.7,846969,184728,662241,2.7,12.6,140970,2.1,25.2,0,84,343,55901,
2007,h) 500 to 999,9436,112906,6173200,6078558,9241,8.4,3335,3,897264,249318,647946,4.1,14.8,710621,150346,560275,2.5,11.7,186643,3.1,23.4,0,27,44,34202,
2007,i) 1000 to 2499,6001,139271,8340402,8203921,12859,9.5,5897,4.3,1156985,319488,837497,3.9,14.1,892304,214356,677948,2.6,10.9,264681,3.2,21.8,0,21,24,57067,
2007,j) 2500 to 4999,2330,110718,6559256,6458338,10010,9.2,5468,5,924165,255929,668236,4,14.3,731387,161966,569421,2.5,11.3,192778,3,22.6,1,2,2,,
2007,k) 5000 to 9999,1315,119183,6610832,6557039,11427,9.7,7847,6.7,864697,242931,621766,3.7,13.2,765624,172967,592657,2.6,11.7,99073,1.5,23.4,0,,,,
2007,l) 10000+,1394,635231,31772613,31689619,75297,12.1,50405,8.1,4509649,1504721,3004928,4.7,14.2,4357312,1215972,3141340,3.8,13.7,152337,0.5,27.4,0,,,,
2008,a) 1 to 4,2894710,2897792,6111859,6196854,509725,17.5,558750,19.2,1747834,1178750,569084,19,28.2,1943877,1245438,698439,20.1,31.4,-196043,-3.2,56.4,0,419207,419256,977351,
2008,b) 5 to 9,1086797,1098817,7096498,7153024,46157,4.2,47373,4.3,1388109,551677,836432,7.7,19.4,1504162,568465,935697,7.9,21,-116053,-1.6,38.8,0,39598,39682,484823,
2008,c) 10 to 19,636208,670223,8588838,8625557,21029,3.1,20716,3.1,1370827,485340,885487,5.6,15.9,1451835,499974,951861,5.8,16.8,-81008,-0.9,31.8,0,16465,16569,426899,
2008,d) 20 to 49,394743,481872,12025243,12032483,13855,2.9,11337,2.4,1687318,519303,1168015,4.3,14,1712894,534523,1178371,4.4,14.2,-25576,-0.2,28,0,7616,7736,444980,
2008,e) 50 to 99,126384,218097,8823416,8755633,6717,3.1,4056,1.9,1244250,326327,917923,3.7,14.2,1115826,330125,785701,3.8,12.7,128424,1.5,25.4,0,1942,2036,260829,
2008,f) 100 to 249,67952,212208,10469257,10343112,8327,4,3494,1.7,1396609,363774,1032835,3.5,13.5,1159155,364599,794556,3.5,11.2,237454,2.3,22.4,0,937,1166,278414,
2008,g) 250 to 499,20024,137209,6817591,6739345,9363,7,3042,2.3,925272,231578,693694,3.4,13.7,772896,152068,620828,2.3,11.5,152376,2.2,23,0,108,238,73265,
2008,h) 500 to 999,9298,115008,6207676,6120132,7917,7,2881,2.6,828190,236339,591851,3.9,13.5,652010,122592,529418,2,10.7,176180,2.8,21.4,0,34,94,48104,
2008,i) 1000 to 2499,5834,141794,8398115,8308943,11026,7.9,5891,4.2,1079396,331839,747557,4,13,903980,186758,717222,2.2,10.9,175416,2.1,21.8,0,18,81,52715,
2008,j) 2500 to 4999,2232,115074,6600615,6544026,9092,8.1,4419,3.9,790427,225130,565297,3.4,12.1,689812,157639,532173,2.4,10.5,100615,1.6,21,0,5,10,34362,
2008,k) 5000 to 9999,1325,116347,6784852,6744723,10848,9.5,5964,5.2,822463,237616,584847,3.5,12.2,744246,170540,573706,2.5,11,78217,1.2,22,1,1,1,,
2008,l) 10000+,1448,657492,32157593,32033994,58780,9.1,36872,5.7,4138029,1453611,2684418,4.5,12.9,3905010,816107,3088903,2.5,12.2,233019,0.7,24.4,0,,,,
2009,a) 1 to 4,2790704,2794337,5834495,6087872,434996,15.1,639713,22.3,1524058,1003980,520078,16.5,25,2121292,1393405,727887,22.9,34.8,-597234,-9.8,50,0,444392,444418,1.02E6,
2009,b) 5 to 9,1055666,1068201,6753399,6956126,38743,3.6,49405,4.6,1190126,470391,719735,6.8,17.1,1623842,583180,1040662,8.4,23.3,-433716,-6.2,34.2,0,38868,38950,474198,
2009,c) 10 to 19,618731,652267,8157312,8390001,16540,2.5,21657,3.3,1143168,402082,741086,4.8,13.6,1630404,500230,1130174,6,19.4,-487236,-5.8,27.2,0,15707,15866,405560,
2009,d) 20 to 49,381111,465080,11255790,11610217,9976,2.1,12496,2.7,1292662,422898,869764,3.6,11.1,2025366,531360,1494006,4.6,17.4,-732704,-6.3,22.2,0,7044,7310,407533,
2009,e) 50 to 99,121104,210732,8120815,8388046,5254,2.5,4940,2.3,874679,248541,626138,3,10.4,1423835,321679,1102156,3.8,17,-549156,-6.6,20.8,0,1719,2065,230309,
2009,f) 100 to 249,66166,210547,9796806,10072284,6396,3.1,4613,2.2,969146,294049,675097,2.9,9.6,1533570,345522,1188048,3.4,15.2,-564424,-5.6,19.2,0,781,1135,232424,
2009,g) 250 to 499,19361,137679,6407113,6546641,9208,6.8,4098,3,703986,208901,495085,3.2,10.8,991084,158662,832422,2.4,15.1,-287098,-4.3,21.6,0,93,235,64162,
2009,h) 500 to 999,9091,118247,5915747,6052666,8550,7.4,4202,3.6,645808,211476,434332,3.5,10.7,920742,150757,769985,2.5,15.2,-274934,-4.5,21.4,0,39,657,52963,
2009,i) 1000 to 2499,5696,141076,7922517,8090569,9853,7.1,5481,3.9,825708,276301,549407,3.4,10.2,1168049,235470,932579,2.9,14.4,-342341,-4.2,20.4,0,25,466,66625,
2009,j) 2500 to 4999,2171,114849,6307739,6426461,8867,7.9,4430,3.9,635129,210773,424356,3.3,9.9,875038,147972,727066,2.3,13.6,-239909,-3.7,19.8,0,3,3,16917,
2009,k) 5000 to 9999,1211,117847,6489899,6595298,9555,8.2,6656,5.7,690373,220638,469735,3.3,10.5,907186,167927,739259,2.5,13.8,-216813,-3.3,21,0,,,,
2009,l) 10000+,1976,646196,30702036,31295001,51365,8,47986,7.4,3049170,1082660,1966510,3.5,9.7,4255431,927820,3327611,3,13.6,-1206261,-3.9,19.4,0,,,,
2010,a) 1 to 4,2785800,2790275,5858303,5974682,483326,17.1,557758,19.7,1611048,1093889,517159,18.3,27,1843805,1212308,631497,20.3,30.9,-232757,-3.9,54,0,390646,390685,891528,
2010,b) 5 to 9,1027438,1040389,6689746,6738731,46051,4.4,43108,4.1,1284819,554224,730595,8.2,19.1,1382788,503697,879091,7.5,20.5,-97969,-1.4,38.2,0,33814,33936,413281,
2010,c) 10 to 19,607684,641728,8106116,8207299,16075,2.5,18833,2.9,1173638,391060,782578,4.8,14.3,1376004,428647,947357,5.2,16.8,-202366,-2.5,28.6,0,13636,13841,352297,
2010,d) 20 to 49,365505,448473,10913478,11093910,10416,2.3,11340,2.5,1281864,430418,851446,3.9,11.6,1642727,455675,1187052,4.1,14.8,-360863,-3.2,23.2,0,6096,6349,356064,
2010,e) 50 to 99,114241,203599,7801418,7886310,8060,4,4682,2.3,955358,351724,603634,4.5,12.1,1125141,307440,817701,3.9,14.3,-169783,-2.2,24.2,0,1717,2020,230393,
2010,f) 100 to 249,63462,210147,9586004,9628618,9695,4.7,4282,2.1,1130319,385879,744440,4,11.7,1215547,329850,885697,3.4,12.6,-85228,-0.9,23.4,0,823,1048,242492,
2010,g) 250 to 499,18322,137624,6155894,6195460,9334,6.9,3783,2.8,729833,232559,497274,3.8,11.8,808965,172157,636808,2.8,13.1,-79132,-1.3,23.6,0,142,267,96127,
2010,h) 500 to 999,8702,118988,5798238,5809926,7984,6.8,3490,3,672161,204956,467205,3.5,11.6,695536,126222,569314,2.2,12,-23375,-0.4,23.2,0,45,152,60919,
2010,i) 1000 to 2499,5497,144168,7833474,7881656,9511,6.7,5707,4,840648,242106,598542,3.1,10.7,937012,194810,742202,2.5,11.9,-96364,-1.2,21.4,0,19,56,62461,
2010,j) 2500 to 4999,2023,115599,6114300,6157219,8372,7.3,5290,4.6,621888,211701,410187,3.4,10.1,707726,160834,546892,2.6,11.5,-85838,-1.4,20.2,0,6,6,35900,
2010,k) 5000 to 9999,1163,115727,6253959,6335518,7820,6.8,5440,4.7,642073,174890,467183,2.8,10.1,805192,139925,665267,2.2,12.7,-163119,-2.6,20.2,0,,,,
2010,l) 10000+,1176,630077,29945611,30107251,46171,7.4,41933,6.7,3075443,1042338,2033105,3.5,10.2,3398724,793522,2605202,2.6,11.3,-323281,-1.1,20.4,0,,,,
2011,a) 1 to 4,2794631,2799504,5925655,5937827,507686,18.1,527530,18.8,1699368,1147428,551940,19.3,28.6,1723711,1141839,581872,19.2,29,-24343,-0.4,57.2,0,411649,411792,931569,
2011,b) 5 to 9,1014763,1027858,6631486,6669425,41992,4.1,43733,4.3,1268435,507656,760779,7.6,19,1344312,511529,832783,7.7,20.2,-75877,-1.2,38,0,36445,36650,445347,
2011,c) 10 to 19,599121,632426,8074309,8074249,16774,2.7,17659,2.8,1230020,412147,817873,5.1,15.2,1229900,398212,831688,4.9,15.2,120,0,30.4,0,13634,13960,350722,
2011,d) 20 to 49,360517,440917,11041542,10926770,11478,2.6,10270,2.3,1495626,455277,1040349,4.2,13.7,1266082,419940,846142,3.8,11.6,229544,2.1,23.2,0,6206,6781,355106,
2011,e) 50 to 99,112467,200041,7818172,7770221,6769,3.4,5016,2.5,1016791,294696,722095,3.8,13.1,920889,299650,621239,3.9,11.9,95902,1.2,23.8,0,1846,2427,243554,
2011,f) 100 to 249,62345,206475,9551216,9460608,6812,3.3,4431,2.2,1145316,302724,842592,3.2,12.1,964099,276329,687770,2.9,10.2,181217,1.9,20.4,0,772,1264,213895,
2011,g) 250 to 499,18348,137213,6354095,6210754,7505,5.6,2965,2.2,868878,235962,632916,3.8,14,582196,129957,452239,2.1,9.4,286682,4.6,18.8,0,122,227,68205,
2011,h) 500 to 999,8796,120599,5994119,5861111,7075,6,2506,2.1,776487,225972,550515,3.9,13.2,510470,88787,421683,1.5,8.7,266017,4.5,17.4,0,53,109,42062,
2011,i) 1000 to 2499,5547,145131,8040611,7911446,7781,5.4,3820,2.7,950719,253145,697574,3.2,12,692390,166040,526350,2.1,8.8,258329,3.2,17.6,0,38,77,65705,
2011,j) 2500 to 4999,2075,120779,6370211,6243413,7228,6.1,4100,3.4,755158,241339,513819,3.9,12.1,501561,98569,402992,1.6,8,253597,4.1,16,0,12,35,17883,
2011,k) 5000 to 9999,1155,116166,6514596,6421776,7586,6.6,5411,4.7,762825,206086,556739,3.2,11.9,577185,127555,449630,2,9,185640,2.9,18,0,8,127,10286,
2011,l) 10000+,1126,641227,30896826,30413125,54093,8.6,32011,5.1,3760212,1115986,2644226,3.7,12.4,2792810,623096,2169714,2,9.2,967402,3.2,18.4,0,18,438,51444,
