year2,sic1,fage4,Firms,Estabs,Emp,Denom,Estabs_Entry,Estabs_Entry_Rate,Estabs_Exit,Estabs_Exit_Rate,Job_Creation,Job_Creation_Births,Job_Creation_Continuers,Job_Creation_Rate_Births,Job_Creation_Rate,Job_Destruction,Job_Destruction_Deaths,Job_Destruction_Continuers,Job_Destruction_Rate_Deaths,Job_Destruction_Rate,Net_Job_Creation,Net_Job_Creation_Rate,Reallocation_Rate,d_flag,firmdeath_firms,firmdeath_estabs,firmdeath_emp
1977,07,a) 0,7319,7397,61316,30658,7135,192.9,0,0,58219,58219,0,189.9,189.9,0,0,0,0,0,58219,189.9,0,0,,,
1977,07,l) Left Censored,28628,29582,214240,221857,169,0.5,7083,21.3,47626,2521,45105,1.1,21.5,62384,28458,33926,12.8,28.1,-14758,-6.6,43,0,4998,5008,19337
1977,10,a) 0,3154,3295,27380,13690,3247,197.1,0,0,26995,26995,0,197.2,197.2,0,0,0,0,0,26995,197.2,0,0,,,
1977,10,l) Left Censored,16208,22152,772893,755969,1100,4.7,3193,13.7,157202,48437,108765,6.4,20.8,123781,50050,73731,6.6,16.4,33421,4.4,32.8,0,1953,1965,20262
1977,15,a) 0,82389,82484,321496,160748,80614,195.5,0,0,314903,314903,0,195.9,195.9,0,0,0,0,0,314903,195.9,0,0,,,
1977,15,l) Left Censored,300944,306400,3076729,3141326,1201,0.4,56838,16.9,666128,50645,615483,1.6,21.2,782855,261511,521344,8.3,24.9,-116727,-3.7,42.4,0,38156,38184,174684
1977,20,a) 0,33274,33840,341896,170948,33221,196.3,0,0,336284,336284,0,196.7,196.7,0,0,0,0,0,336284,196.7,0,0,,,
1977,20,l) Left Censored,226707,282904,18984101,18674788,5582,1.9,31189,10.5,2389041,443153,1945888,2.4,12.8,1780764,544584,1236180,2.9,9.5,608277,3.3,19,0,21340,21425,252348
1977,40,a) 0,20193,21318,128784,64392,20874,195.8,0,0,126687,126687,0,196.7,196.7,0,0,0,0,0,126687,196.7,0,0,,,
1977,40,l) Left Censored,100836,142119,4174671,4041612,3875,2.6,17463,11.7,853924,130992,722932,3.2,21.1,588484,139644,448840,3.5,14.6,265440,6.5,29.2,0,12009,12071,74494
1977,50,a) 0,38458,42657,250547,125274,41963,196.7,0,0,247107,247107,0,197.3,197.3,0,0,0,0,0,247107,197.3,0,0,,,
1977,50,l) Left Censored,236737,325068,4507829,4485636,13716,4,41891,12.3,839160,218342,620818,4.9,18.7,797682,365486,432196,8.1,17.8,41478,0.9,35.6,0,22787,23018,163950
1977,52,a) 0,172702,193806,1227451,613726,190868,197,0,0,1214470,1214470,0,197.9,197.9,0,0,0,0,0,1214470,197.9,0,0,,,
1977,52,l) Left Censored,767151,1047154,12356330,12569369,41067,3.7,189236,16.8,2284315,696845,1587470,5.5,18.2,2709327,1321269,1388058,10.5,21.6,-425012,-3.4,36.4,0,129340,130482,794134
1977,60,a) 0,40609,41696,162787,81394,40658,195,0,0,159852,159852,0,196.4,196.4,0,0,0,0,0,159852,196.4,0,0,,,
1977,60,l) Left Censored,257185,346674,4356626,4315396,8519,2.3,39291,10.8,638132,134571,503561,3.1,14.8,554775,190312,364463,4.4,12.9,83357,1.9,25.8,0,25916,26031,97953
1977,70,a) 0,168712,188217,1250842,625421,184969,196.5,0,0,1232657,1232657,0,197.1,197.1,0,0,0,0,0,1232657,197.1,0,0,,,
1977,70,l) Left Censored,949648,1037008,13878320,13881528,18964,1.7,139822,12.7,2329032,417388,1911644,3,16.8,2310975,1008011,1302964,7.3,16.6,18057,0.2,33.2,0,94711,95108,634695
1978,07,a) 0,6410,6418,24807,12404,6342,197.6,0,0,24548,24548,0,197.9,197.9,0,0,0,0,0,24548,197.9,0,0,,,
1978,07,b) 1,5189,5242,27757,44522,15,0.2,2088,33.1,9392,177,9215,0.4,21.1,42724,8637,34087,19.4,96,-33332,-74.9,42.2,0,1345,1346,4482
1978,07,l) Left Censored,25429,26389,206652,210461,946,3.4,4056,14.5,48725,6841,41884,3.3,23.2,55997,27345,28652,13,26.6,-7272,-3.4,46.4,0,2472,2481,11489
1978,10,a) 0,3031,3038,23165,11583,3023,199,0,0,23129,23129,0,199.7,199.7,0,0,0,0,0,23129,199.7,0,0,,,
1978,10,b) 1,2227,2359,25403,26167,17,0.6,895,31.7,9347,139,9208,0.5,35.7,10571,6735,3836,25.7,40.4,-1224,-4.7,71.4,0,596,600,4505
1978,10,l) Left Censored,14279,20249,737309,755325,977,4.6,2760,13,135106,32826,102280,4.3,17.9,170132,56787,113345,7.5,22.5,-35026,-4.6,35.8,0,1398,1403,14177
1978,15,a) 0,83651,83665,352342,176171,82668,197.6,0,0,349668,349668,0,198.5,198.5,0,0,0,0,0,349668,198.5,0,0,,,
1978,15,b) 1,57017,57114,337070,329057,27,0,24241,34.7,140682,922,139760,0.3,42.8,121582,81916,39666,24.9,36.9,19100,5.9,73.8,0,16576,16576,58373
1978,15,l) Left Censored,269358,274718,3172134,3124657,9272,3.2,39941,13.7,783579,70278,713301,2.2,25.1,680795,241196,439599,7.7,21.8,102784,3.3,43.6,0,26837,26858,143958
1978,20,a) 0,30667,30717,279806,139903,30468,198.4,0,0,279069,279069,0,199.5,199.5,0,0,0,0,0,279069,199.5,0,0,,,
1978,20,b) 1,24875,25419,355205,349522,112,0.4,8205,27.7,116300,6190,110110,1.8,33.3,103791,71134,32657,20.4,29.7,12509,3.6,59.4,0,6100,6110,50143
1978,20,l) Left Censored,206758,262459,19456105,19219545,6513,2.4,26704,9.8,2359249,343091,2016158,1.8,12.3,1891584,691050,1200534,3.6,9.8,467665,2.5,19.6,0,16400,16462,227734
1978,40,a) 0,19034,19129,96737,48369,18952,198.1,0,0,96271,96271,0,199,199,0,0,0,0,0,96271,199,0,0,,,
1978,40,b) 1,14245,15475,135399,133251,131,0.7,5755,31.3,36597,1742,34855,1.3,27.5,31708,19981,11727,15,23.8,4889,3.7,47.6,0,4334,4336,13706
1978,40,l) Left Censored,90000,132063,4120384,4146300,4908,3.6,14630,10.7,673837,118526,555311,2.9,16.3,723376,159885,563491,3.9,17.4,-49539,-1.1,32.6,0,8926,8995,70764
1978,50,a) 0,32184,32465,153686,76843,32229,198.5,0,0,152605,152605,0,198.6,198.6,0,0,0,0,0,152605,198.6,0,0,,,
1978,50,b) 1,30080,34467,242214,245910,564,1.5,8380,21.8,68856,5111,63745,2.1,28,75472,35791,39681,14.6,30.7,-6616,-2.7,56,0,5806,5852,20732
1978,50,l) Left Censored,216195,305515,4585420,4547164,10815,3.4,30071,9.5,823098,153942,669156,3.4,18.1,744054,315745,428309,6.9,16.4,79044,1.7,32.8,0,16388,16597,102005
1978,52,a) 0,139946,142636,917545,458773,141621,198.6,0,0,914643,914643,0,199.4,199.4,0,0,0,0,0,914643,199.4,0,0,,,
1978,52,b) 1,122280,144393,1153208,1188652,3836,2.3,51678,30.6,312820,43660,269160,3.7,26.3,379094,252164,126930,21.2,31.9,-66274,-5.6,52.6,0,38074,38343,170071
1978,52,l) Left Censored,660759,944014,12197622,12279874,41133,4.1,142491,14.3,2190995,561684,1629311,4.6,17.8,2339464,996047,1343417,8.1,19.1,-148469,-1.3,35.6,0,91454,92239,495448
1978,60,a) 0,39159,39435,133300,66650,39005,197.8,0,0,132329,132329,0,198.5,198.5,0,0,0,0,0,132329,198.5,0,0,,,
1978,60,b) 1,30457,31562,164693,162694,137,0.4,9736,26.6,48268,3413,44855,2.1,29.7,42969,28770,14199,17.7,26.4,5299,3.3,52.8,0,6945,6951,21147
1978,60,l) Left Censored,233465,325930,4473055,4411042,11318,3.4,31373,9.3,649984,117407,532577,2.7,14.7,522701,203886,318815,4.6,11.8,127283,2.9,23.6,0,20565,20636,87663
1978,70,a) 0,150256,151106,741107,370554,149679,198.1,0,0,737545,737545,0,199,199,0,0,0,0,0,737545,199,0,0,,,
1978,70,b) 1,128729,149077,1282998,1272108,2298,1.4,39509,23.4,364321,31895,332426,2.5,28.6,336144,170960,165184,13.4,26.4,28177,2.2,52.8,0,27009,27074,107828
1978,70,l) Left Censored,867152,957689,14277673,14051224,29896,3,106459,10.7,2584310,351884,2232426,2.5,18.4,2118954,915617,1203337,6.5,15.1,465356,3.3,30.2,0,69638,70027,530206
1979,07,a) 0,6841,6842,27617,13809,6765,197.7,0,0,27431,,,,198.6,0,0,0,0,0,27431,198.6,0,1,,,
1979,07,b) 1,4871,4878,23953,24426,3,0.1,1427,25.3,7652,,,,31.3,7991,4310,3681,17.6,32.7,-339,-1.4,62.6,1,894,894,2810
1979,07,c) 2,4415,4449,25367,26571,209,4.3,945,19.5,6663,733,5930,2.8,25.1,8827,4767,4060,17.9,33.2,-2164,-8.1,50.2,0,562,565,2596
1979,07,l) Left Censored,23218,24163,195664,201104,794,3.1,2955,11.7,44059,9418,34641,4.7,21.9,54855,17038,37817,8.5,27.3,-10796,-5.4,43.8,0,1726,1742,8882
1979,10,a) 0,3341,3349,32760,16380,3308,197.6,0,0,32543,32543,0,198.7,198.7,0,0,0,0,0,32543,198.7,0,0,,,
1979,10,b) 1,2455,2464,34206,30022,5,0.2,563,20.4,15958,77,15881,0.3,53.2,7489,3764,3725,12.5,24.9,8469,28.3,49.8,0,336,336,2479
1979,10,c) 2,1926,2069,26738,26140,94,4.2,371,16.8,8998,1305,7693,5,34.4,7880,3968,3912,15.2,30.1,1118,4.3,60.2,0,185,185,2145
1979,10,l) Left Censored,13276,19313,821489,777993,848,4.3,1771,9,179987,29842,150145,3.8,23.1,95362,33054,62308,4.2,12.3,84625,10.8,24.6,0,585,591,5001
1979,15,a) 0,79302,79320,365052,182526,78457,197.8,0,0,361707,361707,0,198.2,198.2,0,0,0,0,0,361707,198.2,0,0,,,
1979,15,b) 1,60558,60651,367004,363345,6,0,21485,29.8,141621,203,141418,0.1,39,130078,72653,57425,20,35.8,11543,3.2,71.6,0,14606,14606,50415
1979,15,c) 2,47841,47944,317088,326568,2701,5.1,11061,21.1,98699,11578,87121,3.5,30.2,115211,49354,65857,15.1,35.3,-16512,-5.1,60.4,0,7120,7120,32338
1979,15,l) Left Censored,246337,251575,3258131,3212297,7381,2.8,29276,11.1,753478,60115,693363,1.9,23.5,659855,186656,473199,5.8,20.5,93623,3,41,0,18806,18824,98248
1979,20,a) 0,30362,30472,302677,151339,30265,198.6,0,0,301727,301727,0,199.4,199.4,0,0,0,0,0,301727,199.4,0,0,,,
1979,20,b) 1,24399,24531,329045,313557,74,0.3,5917,21.4,109228,7220,102008,2.3,34.8,76648,42626,34022,13.6,24.4,32580,10.4,48.8,0,4409,4411,31789
1979,20,c) 2,21488,22045,358991,357246,899,3.8,4025,17,87287,10142,77145,2.8,24.4,82945,42813,40132,12,23.2,4342,1.2,46.4,0,2839,2840,27179
1979,20,l) Left Censored,192767,248956,19865541,19651473,7533,2.9,20476,8,2340866,409754,1931112,2.1,11.9,1904312,672883,1231429,3.4,9.7,436554,2.2,19.4,0,11466,11600,171747
1979,40,a) 0,19931,19982,103306,51653,19756,197.7,0,0,102577,102577,0,198.6,198.6,0,0,0,0,0,102577,198.6,0,0,,,
1979,40,b) 1,14542,14631,103281,100366,12,0.1,4183,24.8,33236,616,32620,0.6,33.1,26607,13424,13183,13.4,26.5,6629,6.6,53,0,3088,3088,9653
1979,40,c) 2,12113,13317,135315,134722,655,4.6,2619,18.2,32303,5412,26891,4,24,30738,14644,16094,10.9,22.8,1565,1.2,45.6,0,1798,1805,9146
1979,40,l) Left Censored,82814,124704,4276502,4198848,4324,3.4,11395,8.9,682459,91621,590838,2.2,16.3,524540,139293,385247,3.3,12.5,157919,3.8,25,0,6228,6321,49581
1979,50,a) 0,32293,32653,165415,82708,32435,198.7,0,0,164698,164698,0,199.1,199.1,0,0,0,0,0,164698,199.1,0,0,,,
1979,50,b) 1,26486,26928,169337,162494,189,0.6,5416,18.2,53844,2416,51428,1.5,33.1,39257,18331,20926,11.3,24.2,14587,8.9,48.4,0,3878,3892,12327
1979,50,c) 2,26941,31201,249743,245794,1294,3.9,4327,13.2,56446,8833,47613,3.6,23,48025,21693,26332,8.8,19.5,8421,3.5,39,0,2687,2701,11959
1979,50,l) Left Censored,203188,293122,4608629,4595656,11247,3.8,23080,7.7,708491,158303,550188,3.4,15.4,680188,243438,436750,5.3,14.8,28303,0.6,29.6,0,10659,10829,84929
1979,52,a) 0,136221,140133,916687,458344,139129,198.6,0,0,912752,912752,0,199.1,199.1,0,0,0,0,0,912752,199.1,0,0,,,
1979,52,b) 1,105566,109276,803004,862951,1266,1,33053,26.2,196084,14834,181250,1.7,22.7,309652,167927,141725,19.5,35.9,-113568,-13.2,45.4,0,25010,25040,127897
1979,52,c) 2,102578,124603,1059826,1104065,6858,5.1,25412,18.9,220456,56162,164294,5.1,20,305732,144754,160978,13.1,27.7,-85276,-7.7,40,0,16650,16732,85895
1979,52,l) Left Censored,593753,883647,12231034,12212242,42940,4.7,100506,11,2028022,641376,1386646,5.3,16.6,1977843,713780,1264063,5.8,16.2,50179,0.4,32.4,0,58564,58977,323517
1979,60,a) 0,38657,38693,138639,69320,38233,197.6,0,0,137280,137280,0,198,198,0,0,0,0,0,137280,198,0,0,,,
1979,60,b) 1,31223,31644,137958,137632,71,0.2,7327,20.6,42299,606,41693,0.4,30.7,40399,19727,20672,14.3,29.4,1900,1.3,58.8,0,5120,5121,13555
1979,60,c) 2,26540,27677,162820,165183,1237,4.2,4834,16.3,37480,6913,30567,4.2,22.7,41772,18859,22913,11.4,25.3,-4292,-2.6,45.4,0,3267,3281,10993
1979,60,l) Left Censored,216630,316042,4651068,4558396,14871,4.6,24062,7.5,686077,169127,516950,3.7,15.1,498719,149694,349025,3.3,10.9,187358,4.2,21.8,0,14419,14477,55608
1979,70,a) 0,151259,152160,810588,405294,150771,198.2,0,0,804851,,,,198.6,0,0,0,0,0,804851,198.6,0,1,,,
1979,70,b) 1,120673,122388,832023,809033,736,0.5,27360,20,251626,,,,31.1,200175,100449,99726,12.4,24.7,51451,6.4,49.4,1,18805,18808,70385
1979,70,c) 2,114046,134467,1295142,1287248,7140,5,20440,14.4,299427,56298,243129,4.4,23.3,280604,116050,164554,9,21.8,18823,1.5,43.6,0,12309,12342,56915
1979,70,l) Left Censored,811611,906121,14820429,14544977,29284,3.1,77614,8.3,2474635,386252,2088383,2.7,17,1911863,622777,1289086,4.3,13.1,562772,3.9,26.2,0,47532,47935,316088
1980,07,a) 0,6134,6138,24424,12212,6066,197.7,0,0,24200,,,,198.2,0,0,0,0,0,24200,198.2,0,1,,,
1980,07,b) 1,4851,4852,23804,25662,1,0,1700,29.1,7066,,,,27.5,9717,5873,3844,22.9,37.9,-2651,-10.4,55,1,1219,1219,4380
1980,07,c) 2,3969,3976,20838,22386,129,2.9,917,20.7,5097,440,4657,2,22.8,7737,3157,4580,14.1,34.6,-2640,-11.8,45.6,0,701,701,2465
1980,07,d) 3,3850,3875,22575,23971,156,3.7,703,16.9,4853,740,4113,3.1,20.2,7541,2729,4812,11.4,31.5,-2688,-11.3,40.4,0,489,489,1940
1980,07,l) Left Censored,21203,22164,185189,190484,597,2.6,2504,10.8,31877,3941,27936,2.1,16.7,42044,12893,29151,6.8,22.1,-10167,-5.4,33.4,0,1741,1742,7785
1980,10,a) 0,3460,3466,30473,15237,3448,199,0,0,30409,30409,0,199.6,199.6,0,0,0,0,0,30409,199.6,0,0,,,
1980,10,b) 1,2361,2371,30473,31701,4,0.1,762,26.6,10455,39,10416,0.1,33,10724,6596,4128,20.8,33.8,-269,-0.8,66,0,657,658,5698
1980,10,c) 2,1961,1968,28467,31253,62,2.8,469,21.2,6837,385,6452,1.2,21.9,11244,5597,5647,17.9,36,-4407,-14.1,43.8,0,412,417,5008
1980,10,d) 3,1680,1813,27275,27106,65,3.3,320,16.5,7945,1562,6383,5.8,29.3,7570,4418,3152,16.3,27.9,375,1.4,55.8,0,237,237,2461
1980,10,l) Left Censored,12156,18262,828802,825046,818,4.4,1836,9.8,130468,29314,101154,3.6,15.8,122095,32693,89402,4,14.8,8373,1,29.6,0,1013,1029,12116
1980,15,a) 0,63305,63318,284961,142481,62508,197.4,0,0,282770,282770,0,198.5,198.5,0,0,0,0,0,282770,198.5,0,0,,,
1980,15,b) 1,51781,51804,303515,334741,10,0,23630,36,102143,224,101919,0.1,30.5,146401,84099,62302,25.1,43.7,-44258,-13.2,61,0,18732,18733,70154
1980,15,c) 2,46290,46385,284835,325882,1960,3.7,14614,27.3,74500,6939,67561,2.1,22.9,146050,68359,77691,21,44.8,-71550,-21.9,45.8,0,11236,11236,55831
1980,15,d) 3,39314,39411,266138,291689,1763,4,9714,22.2,62813,6024,56789,2.1,21.5,111498,43203,68295,14.8,38.2,-48685,-16.7,43,0,7203,7203,32978
1980,15,l) Left Censored,220622,225650,3029722,3143002,5543,2.3,29852,12.5,554313,42993,511320,1.4,17.6,774105,186177,587928,5.9,24.6,-219792,-7,35.2,0,21612,21625,112778
1980,20,a) 0,28210,28299,260723,130362,28077,198.4,0,0,259684,259684,0,199.2,199.2,0,0,0,0,0,259684,199.2,0,0,,,
1980,20,b) 1,23261,23440,312843,309236,100,0.4,6056,22.5,97546,9198,88348,3,31.5,82224,46049,36175,14.9,26.6,15322,4.9,53.2,0,5083,5083,37980
1980,20,c) 2,20299,20446,286311,303996,601,2.7,4299,19.1,58665,6882,51783,2.3,19.3,90109,43901,46208,14.4,29.6,-31444,-10.3,38.6,0,3647,3647,37451
1980,20,d) 3,18807,19356,333996,347163,603,2.9,3195,15.4,61288,9258,52030,2.7,17.7,86499,35045,51454,10.1,24.9,-25211,-7.2,35.4,0,2555,2560,24839
1980,20,l) Left Censored,179754,236031,19496855,19682043,6260,2.6,18955,7.8,2041235,415554,1625681,2.1,10.4,2377282,658895,1718387,3.3,12.1,-336047,-1.7,20.8,0,11905,12014,171665
1980,40,a) 0,17838,17869,96397,48199,17713,198.3,0,0,95915,95915,0,199,199,0,0,0,0,0,95915,199,0,0,,,
1980,40,b) 1,14148,14214,98844,101829,25,0.1,4955,29,28451,633,27818,0.6,27.9,30512,16210,14302,15.9,30,-2061,-2.1,55.8,0,4183,4183,13936
1980,40,c) 2,11811,11915,90917,97118,363,2.7,2806,21.1,19168,1602,17566,1.6,19.7,29439,14210,15229,14.6,30.3,-10271,-10.6,39.4,0,2346,2346,12253
1980,40,d) 3,10409,11567,131924,129856,492,4,2020,16.3,33095,13233,19862,10.2,25.5,28654,11355,17299,8.7,22.1,4441,3.4,44.2,0,1609,1609,8158
1980,40,l) Left Censored,75952,118436,4251606,4268291,3708,3,9922,8.2,632875,64713,568162,1.5,14.8,664652,110659,553993,2.6,15.6,-31777,-0.8,29.6,0,6443,6527,47853
1980,50,a) 0,29976,30247,149859,74930,30035,198.6,0,0,149214,149214,0,199.1,199.1,0,0,0,0,0,149214,199.1,0,0,,,
1980,50,b) 1,25261,25681,157093,161499,186,0.6,5843,20,41919,2449,39470,1.5,26,44201,23528,20673,14.6,27.4,-2282,-1.4,52,0,4774,4785,17709
1980,50,c) 2,22562,23053,154969,161717,701,2.8,4137,16.6,32133,4340,27793,2.7,19.9,43415,20357,23058,12.6,26.8,-11282,-6.9,39.8,0,3440,3440,17288
1980,50,d) 3,23973,28083,238749,244473,958,3.2,4003,13.5,41522,6389,35133,2.6,17,52483,22349,30134,9.1,21.5,-10961,-4.5,34,0,2552,2567,11811
1980,50,l) Left Censored,190456,280713,4586838,4596505,9724,3.4,21684,7.6,628179,166686,461493,3.6,13.7,643378,217438,425940,4.7,14,-15199,-0.3,27.4,0,11408,11545,76883
1980,52,a) 0,121551,124388,809953,404977,123400,198.4,0,0,806312,806312,0,199.1,199.1,0,0,0,0,0,806312,199.1,0,0,,,
1980,52,b) 1,98729,103471,752784,837871,1124,0.9,33442,27.4,166536,14437,152099,1.7,19.9,310279,174599,135680,20.8,37,-143743,-17.1,39.8,0,28240,28308,147314
1980,52,c) 2,84520,88569,687653,743535,3622,3.7,22517,22.8,138275,40025,98250,5.4,18.6,239539,122319,117220,16.5,32.2,-101264,-13.6,37.2,0,18891,19006,102534
1980,52,d) 3,86645,108114,984124,1021332,5189,4.5,21062,18.1,202268,45110,157158,4.4,19.8,274842,126594,148248,12.4,26.9,-72574,-7.1,39.6,0,14531,14676,79193
1980,52,l) Left Censored,532996,826359,11723227,11973519,36624,4.3,91732,10.7,1657849,598415,1059434,5,13.8,2149036,702564,1446472,5.9,17.9,-491187,-4.1,27.6,0,57258,57852,341965
1980,60,a) 0,35172,35231,124746,62373,34833,197.7,0,0,123773,123773,0,198.4,198.4,0,0,0,0,0,123773,198.4,0,0,,,
1980,60,b) 1,28542,28894,124142,132065,41,0.1,8567,25.2,36503,3111,33392,2.4,27.6,47562,26305,21257,19.9,36,-11059,-8.4,55.2,0,6744,6745,20726
1980,60,c) 2,25824,26339,118520,128060,822,2.8,5519,19,23559,3380,20179,2.6,18.4,40240,19256,20984,15,31.4,-16681,-13,36.8,0,4444,4444,15090
1980,60,d) 3,23089,24236,154711,158761,828,3.2,4127,15.9,27702,4034,23668,2.5,17.4,35379,16483,18896,10.4,22.3,-7677,-4.9,34.8,0,3184,3201,11910
1980,60,l) Left Censored,200772,302227,4705305,4675109,10680,3.5,23754,7.7,587263,138551,448712,3,12.6,525390,166825,358565,3.6,11.2,61873,1.4,22.4,0,14828,14925,63567
1980,70,a) 0,146193,147214,723124,361562,145904,198.2,0,0,719550,,,,199,0,0,0,0,0,719550,199,0,1,,,
1980,70,b) 1,115283,116698,818523,836255,671,0.5,29485,21.9,221789,,,,26.5,228139,116610,111529,13.9,27.3,-6350,-0.8,53,1,22974,22983,93112
1980,70,c) 2,102613,104877,736452,767814,4336,3.8,19240,17,158455,23951,134504,3.1,20.6,208863,96112,112751,12.5,27.2,-50408,-6.6,41.2,0,14994,14995,76607
1980,70,d) 3,101758,121994,1283408,1288097,5333,4.2,17276,13.5,265548,64923,200625,5,20.6,272713,108297,164416,8.4,21.2,-7165,-0.6,41.2,0,11109,11216,59959
1980,70,l) Left Censored,758809,855157,14970109,14906670,24016,2.7,72754,8.3,2030031,337596,1692435,2.3,13.6,1889871,596722,1293149,4,12.7,140160,0.9,25.4,0,49458,49790,328448
1981,07,a) 0,6365,6365,30226,15113,6173,194,0,0,29217,29217,0,193.3,193.3,0,0,0,0,0,29217,193.3,0,0,,,
1981,07,b) 1,4433,4435,21498,22960,0,0,1538,29.1,6674,0,6674,0,29.1,9008,5829,3179,25.4,39.2,-2334,-10.1,58.2,0,1040,1040,4341
1981,07,c) 2,4143,4144,22258,23030,158,3.5,930,20.7,5583,539,5044,2.3,24.2,7818,3695,4123,16,33.9,-2235,-9.7,48.4,0,615,615,2687
1981,07,d) 3,3382,3387,19305,20054,112,3,697,18.9,4672,418,4254,2.1,23.3,6396,3421,2975,17.1,31.9,-1724,-8.6,46.6,0,448,449,2233
1981,07,e) 4,3282,3300,20767,21670,123,3.4,658,18.4,4412,389,4023,1.8,20.4,6393,3091,3302,14.3,29.5,-1981,-9.1,40.8,0,407,408,2028
1981,07,l) Left Censored,18873,19801,172762,178778,577,2.8,2819,13.4,32272,5109,27163,2.9,18.1,43702,19892,23810,11.1,24.4,-11430,-6.3,36.2,0,1798,1804,9974
1981,10,a) 0,5431,5434,57823,28912,5250,193.2,0,0,54960,54960,0,190.1,190.1,0,0,0,0,0,54960,190.1,0,0,,,
1981,10,b) 1,2619,2628,37896,34164,11,0.4,801,26.3,17490,361,17129,1.1,51.2,9867,6786,3081,19.9,28.9,7623,22.3,57.8,0,631,631,5866
1981,10,c) 2,2118,2137,34842,32614,63,2.8,443,19.7,9726,1046,8680,3.2,29.8,8786,5735,3051,17.6,26.9,940,2.9,53.8,0,357,357,4828
1981,10,d) 3,1708,1717,30407,29359,41,2.2,335,18.2,7853,453,7400,1.5,26.7,7135,3917,3218,13.3,24.3,718,2.4,48.6,0,255,255,3325
1981,10,e) 4,1445,1543,27724,27241,57,3.4,304,18.2,7303,990,6313,3.6,26.8,6232,3090,3142,11.3,22.9,1071,3.9,45.8,0,185,186,2112
1981,10,l) Left Censored,11055,17235,865434,847216,923,5.2,1912,10.8,161002,30460,130542,3.6,19,124028,44187,79841,5.2,14.6,36974,4.4,29.2,0,845,849,11106
1981,15,a) 0,52289,52297,295233,147617,50327,192.5,0,0,281605,281605,0,190.8,190.8,0,0,0,0,0,281605,190.8,0,0,,,
1981,15,b) 1,41194,41214,254997,269911,12,0,19680,37.7,92454,887,91567,0.3,34.3,116189,70097,46092,26,43,-23735,-8.7,68.6,0,14327,14328,53490
1981,15,c) 2,40493,40515,263909,283840,1581,3.4,13065,28.3,68440,8260,60180,2.9,24.1,118676,56402,62274,19.9,41.8,-50236,-17.7,48.2,0,9266,9266,42182
1981,15,d) 3,36706,36809,240078,261774,1597,3.8,10643,25.6,57729,6256,51473,2.4,22.1,104755,45897,58858,17.5,40,-47026,-17.9,44.2,0,7588,7589,34472
1981,15,e) 4,31781,31905,224787,245527,1410,4,8162,22.9,52496,6021,46475,2.5,21.4,91959,36999,54960,15.1,37.5,-39463,-16.1,42.8,0,5550,5550,25581
1981,15,l) Left Censored,193205,198078,2704863,2862993,4924,2.3,29585,14,472275,70989,401286,2.5,16.5,778488,208746,569742,7.3,27.2,-306213,-10.7,33,0,19160,19179,100206
1981,20,a) 0,28049,28141,367919,183960,27440,195,0,0,359588,359588,0,195.5,195.5,0,0,0,0,0,359588,195.5,0,0,,,
1981,20,b) 1,21520,21629,261786,262943,51,0.2,6220,24.9,80031,4140,75891,1.6,30.4,79856,51658,28198,19.6,30.4,175,0,60.8,0,4683,4684,35546
1981,20,c) 2,19817,20009,284627,298838,478,2.2,4269,19.7,56791,7081,49710,2.4,19,94156,51590,42566,17.3,31.5,-37365,-12.5,38,0,3203,3206,39308
1981,20,d) 3,17445,17609,267551,275409,499,2.6,3356,17.7,51732,8094,43638,2.9,18.8,70079,33758,36321,12.3,25.4,-18347,-6.6,37.6,0,2601,2603,25094
1981,20,e) 4,16337,16896,317169,324605,524,2.9,2865,15.8,58937,11996,46941,3.7,18.2,72805,32662,40143,10.1,22.4,-13868,-4.2,36.4,0,1966,1970,17765
1981,20,l) Left Censored,165332,221115,18488476,18986389,6512,2.8,20867,9.1,1807638,480262,1327376,2.5,9.5,2792777,867507,1925270,4.6,14.7,-985139,-5.2,19,0,10633,10720,191349
1981,40,a) 0,17302,17304,113291,56646,16808,194.3,0,0,108444,108444,0,191.4,191.4,0,0,0,0,0,108444,191.4,0,0,,,
1981,40,b) 1,12875,12918,91508,94016,25,0.2,4547,29.5,26522,325,26197,0.3,28.2,30420,18340,12080,19.5,32.4,-3898,-4.2,56.4,0,3491,3491,14092
1981,40,c) 2,11616,11695,94351,96042,312,2.4,2930,22.8,20445,1143,19302,1.2,21.3,27663,15773,11890,16.4,28.8,-7218,-7.5,42.6,0,2233,2235,11991
1981,40,d) 3,9636,9731,79465,83595,290,2.7,2113,19.9,14915,1404,13511,1.7,17.8,24486,12215,12271,14.6,29.3,-9571,-11.5,35.6,0,1645,1645,8711
1981,40,e) 4,8789,9955,123299,125629,458,4.3,1801,16.9,21656,3491,18165,2.8,17.2,25994,11526,14468,9.2,20.7,-4338,-3.5,34.4,0,1213,1222,6282
1981,40,l) Left Censored,66418,108634,4219668,4211606,3811,3.4,10862,9.7,686878,77924,608954,1.9,16.3,668712,157398,511314,3.7,15.9,18166,0.4,31.8,0,5498,5580,44268
1981,50,a) 0,32897,33094,193108,96554,32166,194.4,0,0,186916,186916,0,193.6,193.6,0,0,0,0,0,186916,193.6,0,0,,,
1981,50,b) 1,23771,24115,147291,149365,191,0.7,5840,21.5,43810,2128,41682,1.4,29.3,46598,26082,20516,17.5,31.2,-2788,-1.9,58.6,0,4236,4239,17665
1981,50,c) 2,22259,22788,153668,155238,689,2.8,4212,17.4,32383,5174,27209,3.3,20.9,41882,22398,19484,14.4,27,-9499,-6.1,41.8,0,3022,3037,14380
1981,50,d) 3,19808,20323,149513,152272,562,2.6,3379,15.6,30026,4037,25989,2.7,19.7,37493,18529,18964,12.2,24.6,-7467,-4.9,39.4,0,2538,2544,12457
1981,50,e) 4,21052,24449,222338,230491,822,3.1,4402,16.8,37569,6793,30776,2.9,16.3,53395,28822,24573,12.5,23.2,-15826,-6.9,32.6,0,2100,2128,10821
1981,50,l) Left Censored,175757,263888,4441280,4511390,10770,4,27120,10,616278,184790,431488,4.1,13.7,755075,287935,467140,6.4,16.7,-138797,-3,27.4,0,10385,10524,74158
1981,52,a) 0,120716,122091,833358,416679,119094,195.1,0,0,813518,813518,0,195.2,195.2,0,0,0,0,0,813518,195.2,0,0,,,
1981,52,b) 1,87975,91118,680825,747668,1151,1.1,32261,29.9,155572,17035,138537,2.3,20.8,281775,173377,108398,23.2,37.7,-126203,-16.9,41.6,0,24465,24499,125309
1981,52,c) 2,81300,86168,673021,713372,3761,4,22708,24,131746,34513,97233,4.8,18.5,228910,134742,94168,18.9,32.1,-97164,-13.6,37,0,16593,16634,93734
1981,52,d) 3,69787,73639,585171,636661,2913,3.6,17928,22.1,101662,24726,76936,3.9,16,209141,107465,101676,16.9,32.8,-107479,-16.8,32,0,13299,13345,74162
1981,52,e) 4,72303,89959,852251,917974,4045,4.1,21498,21.7,138611,45059,93552,4.9,15.1,267006,140744,126262,15.3,29.1,-128395,-14,30.2,0,10996,11168,63750
1981,52,l) Left Censored,470066,755392,11099951,11404334,35360,4.5,103343,13.1,1500665,558470,942195,4.9,13.2,2094043,859950,1234093,7.5,18.4,-593378,-5.2,26.4,0,49887,50694,297098
1981,60,a) 0,34115,34128,155502,77751,33222,194.7,0,0,151485,151485,0,194.8,194.8,0,0,0,0,0,151485,194.8,0,0,,,
1981,60,b) 1,25844,25906,118780,122007,30,0.1,8311,27.2,35128,525,34603,0.4,28.8,39464,23450,16014,19.2,32.3,-4336,-3.5,57.6,0,6068,6068,16604
1981,60,c) 2,23738,24121,110336,115107,788,3,5728,21.6,23597,3740,19857,3.2,20.5,35679,17646,18033,15.3,31,-12082,-10.5,41,0,4199,4199,12675
1981,60,d) 3,21678,22188,111854,115083,607,2.5,4502,18.6,21025,2514,18511,2.2,18.3,28056,13708,14348,11.9,24.4,-7031,-6.1,36.6,0,3402,3402,10200
1981,60,e) 4,19717,20953,139401,145861,868,3.9,3749,16.6,20846,4683,16163,3.2,14.3,33316,15444,17872,10.6,22.8,-12470,-8.5,28.6,0,2614,2615,9129
1981,60,l) Left Censored,181684,284645,4747843,4714035,10767,3.7,26102,8.9,632467,191083,441384,4.1,13.4,561023,184913,376110,3.9,11.9,71444,1.5,23.8,0,13631,13724,57692
1981,70,a) 0,156537,157486,915284,457642,153272,194.6,0,0,890074,890074,0,194.5,194.5,0,0,0,0,0,890074,194.5,0,0,,,
1981,70,b) 1,112044,113498,731967,739625,803,0.6,30959,23.7,211697,12963,198734,1.8,28.6,217540,125159,92381,16.9,29.4,-5843,-0.8,57.2,0,21377,21399,85789
1981,70,c) 2,100885,102663,790087,788307,4216,3.9,19763,18.1,181712,30147,151565,3.8,23.1,199005,101031,97974,12.8,25.2,-17293,-2.1,46.2,0,13559,13565,67799
1981,70,d) 3,89056,91599,674404,694766,3562,3.6,16021,16.4,130679,26756,103923,3.9,18.8,177056,81957,95099,11.8,25.5,-46377,-6.7,37.6,0,11001,11002,52199
1981,70,e) 4,88895,106397,1133564,1186751,4691,4.1,18882,16.6,199594,48469,151125,4.1,16.8,301788,137399,164389,11.6,25.4,-102194,-8.6,33.6,0,9153,9258,50186
1981,70,l) Left Censored,687586,781738,13847989,13924972,22615,2.8,81139,10,1816596,407902,1408694,2.9,13,1952649,764734,1187915,5.5,14,-136053,-1,26,0,44080,44403,301252
1982,07,a) 0,6262,6267,30666,15333,6205,198,0,0,30506,30506,0,199,199,0,0,0,0,0,30506,199,0,0,,,
1982,07,b) 1,4833,4834,27293,28750,7,0.1,1348,24.1,7774,202,7572,0.7,27,10277,6065,4212,21.1,35.7,-2503,-8.7,54,0,817,817,3749
1982,07,c) 2,3781,3784,20321,20902,213,5.2,781,19,5567,1302,4265,6.2,26.6,6527,2910,3617,13.9,31.2,-960,-4.6,53.2,0,433,433,1608
1982,07,d) 3,3681,3682,20493,21376,203,5.2,616,15.7,4806,916,3890,4.3,22.5,6439,2662,3777,12.5,30.1,-1633,-7.6,45,0,341,341,1449
1982,07,e) 4,3006,3013,17685,18482,148,4.6,467,14.6,4157,718,3439,3.9,22.5,5634,2126,3508,11.5,30.5,-1477,-8,45,0,264,264,1167
1982,07,f) 5,2936,2961,21079,21052,198,6.3,487,15.6,5796,2064,3732,9.8,27.5,5510,2108,3402,10,26.2,286,1.3,52.4,0,247,247,1052
1982,07,l) Left Censored,17545,18621,174941,173759,822,4.3,1838,9.6,37506,7798,29708,4.5,21.6,34832,10051,24781,5.8,20,2674,1.6,40,0,991,991,4742
1982,10,a) 0,6113,6156,62802,31401,6131,199.2,0,0,62540,62540,0,199.2,199.2,0,0,0,0,0,62540,199.2,0,0,,,
1982,10,b) 1,4238,4294,67187,62405,37,0.8,1088,22.4,28312,1349,26963,2.2,45.4,18534,10324,8210,16.5,29.7,9778,15.7,59.4,0,825,825,8066
1982,10,c) 2,2161,2188,30657,33760,102,4.2,493,20.5,7557,952,6605,2.8,22.4,13619,6522,7097,19.3,40.3,-6062,-17.9,44.8,0,317,317,4912
1982,10,d) 3,1802,1838,30289,31369,82,4.1,329,16.6,7576,1315,6261,4.2,24.2,9567,3913,5654,12.5,30.5,-1991,-6.3,48.4,0,207,207,2465
1982,10,e) 4,1452,1470,25541,27201,71,4.5,253,16,6109,676,5433,2.5,22.5,9271,3367,5904,12.4,34.1,-3162,-11.6,45,0,168,170,2272
1982,10,f) 5,1289,1414,26390,27166,112,7.6,222,15,6070,1737,4333,6.4,22.3,7585,2813,4772,10.4,27.9,-1515,-5.6,44.6,0,142,142,1697
1982,10,l) Left Censored,10219,16562,871677,871071,1100,6.5,1666,9.8,168576,34482,134094,4,19.4,166982,51961,115021,6,19.2,1594,0.2,38.4,0,644,645,9741
1982,15,a) 0,44016,44063,229154,114577,43642,198.1,0,0,227007,227007,0,198.1,198.1,0,0,0,0,0,227007,198.1,0,0,,,
1982,15,b) 1,36397,36477,263525,279175,76,0.2,13906,31.3,88566,2426,86140,0.9,31.7,113870,54276,59594,19.4,40.8,-25304,-9.1,63.4,0,8791,8791,38318
1982,15,c) 2,32316,32356,193883,222525,1747,4.8,9519,25.9,51963,8040,43923,3.6,23.4,106217,45456,60761,20.4,47.7,-54254,-24.3,46.8,0,5674,5674,30696
1982,15,d) 3,32931,32983,216292,239478,1995,5.4,8517,23.2,54917,7810,47107,3.3,22.9,98413,38031,60382,15.9,41.1,-43496,-18.2,45.8,0,4810,4810,23137
1982,15,e) 4,30045,30167,194312,216778,1697,5.1,7375,22,45353,6867,38486,3.2,20.9,88058,33077,54981,15.3,40.6,-42705,-19.7,41.8,0,3997,3997,20423
1982,15,f) 5,26493,26591,183343,203694,1645,5.6,6145,21,40946,8675,32271,4.3,20.1,79718,27133,52585,13.3,39.1,-38772,-19,40.2,0,3106,3106,15576
1982,15,l) Left Censored,173100,178630,2460434,2570616,7102,3.8,24133,12.8,488739,110348,378391,4.3,19,702180,151206,550974,5.9,27.3,-213441,-8.3,38,0,13171,13176,71009
1982,20,a) 0,27052,27194,295378,147689,27029,198.8,0,0,293105,293105,0,198.5,198.5,0,0,0,0,0,293105,198.5,0,0,,,
1982,20,b) 1,22535,22971,383112,387146,221,0.9,5002,19.5,95501,12292,83209,3.2,24.7,102032,46794,55238,12.1,26.4,-6531,-1.7,49.4,0,3509,3509,31799
1982,20,c) 2,18488,18650,243193,251307,836,4.2,3485,17.4,55099,9934,45165,4,21.9,70497,33750,36747,13.4,28.1,-15398,-6.2,43.8,0,2307,2309,23320
1982,20,d) 3,17440,17687,259927,269692,790,4.2,2783,14.8,52305,10826,41479,4,19.4,70876,28390,42486,10.5,26.3,-18571,-6.9,38.8,0,1826,1827,19516
1982,20,e) 4,15527,15738,239337,249928,623,3.7,2227,13.4,41193,8622,32571,3.4,16.5,61813,22332,39481,8.9,24.7,-20620,-8.2,33,0,1404,1404,15567
1982,20,f) 5,14761,15425,307924,316156,756,4.7,2113,13.1,51183,12592,38591,4,16.2,66834,25327,41507,8,21.1,-15651,-4.9,32.4,0,1244,1245,13498
1982,20,l) Left Censored,155954,212560,17373840,17922393,7843,3.6,16018,7.4,1567229,400271,1166958,2.2,8.7,2653563,577158,2076405,3.2,14.8,-1086334,-6.1,17.4,0,7550,7605,119337
1982,40,a) 0,18274,18781,127935,63968,18658,198.7,0,0,121120,121120,0,189.3,189.3,0,0,0,0,0,121120,189.3,0,0,,,
1982,40,b) 1,13219,13317,115863,115124,66,0.4,3691,24.1,34402,879,33523,0.8,29.9,31608,17166,14442,14.9,27.5,2794,2.4,55,0,2657,2657,12930
1982,40,c) 2,10863,10967,85849,88505,521,4.4,2268,19,20751,3148,17603,3.6,23.4,25629,12278,13351,13.9,29,-4878,-5.6,46.8,0,1457,1457,8141
1982,40,d) 3,10031,10169,86349,90052,509,4.7,1843,16.9,17637,3194,14443,3.5,19.6,24689,11004,13685,12.2,27.4,-7052,-7.8,39.2,0,1171,1171,7039
1982,40,e) 4,8394,8555,73174,76021,429,4.7,1431,15.7,14091,2702,11389,3.6,18.5,19472,7687,11785,10.1,25.6,-5381,-7.1,37,0,879,879,5393
1982,40,f) 5,7817,9117,123015,123072,584,6.1,1324,13.9,22564,4704,17860,3.8,18.3,22358,8865,13493,7.2,18.2,206,0.1,36.4,0,729,730,4533
1982,40,l) Left Censored,61567,105608,4204840,4212052,5271,4.9,7860,7.3,478455,124155,354300,2.9,11.4,492128,101375,390753,2.4,11.7,-13673,-0.3,22.8,0,3858,3882,34518
1982,50,a) 0,33597,34455,202329,101165,34262,198.9,0,0,200504,200504,0,198.2,198.2,0,0,0,0,0,200504,198.2,0,0,,,
1982,50,b) 1,27200,28084,195857,198918,580,1.9,5344,17.4,48461,6605,41856,3.3,24.4,52740,24441,28299,12.3,26.5,-4279,-2.1,48.8,0,3713,3714,15888
1982,50,c) 2,20844,21519,136170,141005,1186,5.2,3445,15.1,31431,8285,23146,5.9,22.3,40780,17173,23607,12.2,28.9,-9349,-6.6,44.6,0,2296,2296,12401
1982,50,d) 3,20025,21034,146458,148774,1291,5.9,2833,13,33212,10239,22973,6.9,22.3,37217,14940,22277,10,25,-4005,-2.7,44.6,0,1857,1857,9928
1982,50,e) 4,17692,18616,140265,144026,1017,5.2,2498,12.9,27676,8549,19127,5.9,19.2,34740,13728,21012,9.5,24.1,-7064,-4.9,38.4,0,1573,1573,9015
1982,50,f) 5,19467,23507,224259,223974,1524,6.3,2414,10.1,43005,14893,28112,6.6,19.2,42077,15466,26611,6.9,18.8,928,0.4,37.6,0,1325,1332,7843
1982,50,l) Left Censored,166671,258785,4329288,4384897,14517,5.5,19635,7.5,651064,215814,435250,4.9,14.8,758580,253805,504775,5.8,17.3,-107516,-2.5,29.6,0,7665,7725,58578
1982,52,a) 0,119748,126770,971167,485584,126050,198.9,0,0,966636,966636,0,199.1,199.1,0,0,0,0,0,966636,199.1,0,0,,,
1982,52,b) 1,91773,97512,811400,838596,3639,3.3,27851,25.2,240261,61246,179015,7.3,28.7,286568,154213,132355,18.4,34.2,-46307,-5.5,57.4,0,20498,20498,112420
1982,52,c) 2,72961,78455,603473,639384,6103,7.2,17550,20.7,136946,53574,83372,8.4,21.4,205174,105574,99600,16.5,32.1,-68228,-10.7,42.8,0,12065,12074,70878
1982,52,d) 3,68974,76781,606830,638156,6282,7.7,14824,18.2,130134,53457,76677,8.4,20.4,189623,90938,98685,14.3,29.7,-59489,-9.3,40.8,0,9879,9886,59339
1982,52,e) 4,59818,66383,573366,579574,5369,7.7,12059,17.2,144917,59570,85347,10.3,25,154782,71815,82967,12.4,26.7,-9865,-1.7,50,0,7738,7742,45805
1982,52,f) 5,64048,85358,843800,852413,7451,8.5,11662,13.3,189876,93428,96448,11,22.3,204313,78931,125382,9.3,24,-14437,-1.7,44.6,0,6640,6670,39549
1982,52,l) Left Censored,428250,736954,10908880,10999111,55062,7.4,70263,9.4,1709035,756040,952995,6.9,15.5,1881413,608865,1272548,5.5,17.1,-172378,-1.6,31,0,34143,34329,206639
1982,60,a) 0,32487,32604,147254,73627,32322,198.3,0,0,146292,146292,0,198.7,198.7,0,0,0,0,0,146292,198.7,0,0,,,
1982,60,b) 1,26043,26232,144594,150948,94,0.3,6783,22.4,34688,677,34011,0.4,23,44829,22671,22158,15,29.7,-10141,-6.7,46,0,4721,4721,16549
1982,60,c) 2,21236,21320,103630,110234,1005,4.3,4714,20,23642,4359,19283,4,21.4,35560,16337,19223,14.8,32.3,-11918,-10.9,42.8,0,3054,3054,10197
1982,60,d) 3,20063,20469,100525,105330,1014,4.5,3871,17.4,21748,4689,17059,4.5,20.6,30134,13800,16334,13.1,28.6,-8386,-8,41.2,0,2480,2480,8715
1982,60,e) 4,18212,18730,101167,104510,816,4,3357,16.4,20552,3649,16903,3.5,19.7,26033,11716,14317,11.2,24.9,-5481,-5.2,39.4,0,2066,2066,8031
1982,60,f) 5,16830,18072,129917,134374,971,5,3021,15.5,19457,5012,14445,3.7,14.5,27332,10988,16344,8.2,20.3,-7875,-5.8,29,0,1804,1804,6383
1982,60,l) Left Censored,164356,267823,4695868,4722426,11988,4.3,23430,8.5,562693,160099,402594,3.4,11.9,608211,168172,440039,3.6,12.9,-45518,-1,23.8,0,10451,10526,51340
1982,70,a) 0,162112,165830,984701,492351,164922,198.9,0,0,971341,971341,0,197.3,197.3,0,0,0,0,0,971341,197.3,0,0,,,
1982,70,b) 1,125656,129703,948167,953475,2910,2,27797,19.3,253579,36270,217309,3.8,26.6,254584,117715,136869,12.3,26.7,-1005,-0.1,53.2,0,18783,18783,82635
1982,70,c) 2,98300,101306,733459,728363,6958,6.5,17004,15.9,216592,79373,137219,10.9,29.7,201627,86953,114674,11.9,27.7,14965,2,55.4,0,10715,10716,56455
1982,70,d) 3,90448,94498,762370,773360,6575,6.7,13487,13.7,189370,87201,102169,11.3,24.5,206578,83722,122856,10.8,26.7,-17208,-2.2,49,0,8466,8470,54031
1982,70,e) 4,79718,84753,692439,687808,5694,6.4,11403,12.9,179627,72743,106884,10.6,26.1,166963,62887,104076,9.1,24.3,12664,1.8,48.6,0,6917,6918,40451
1982,70,f) 5,81626,102215,1166373,1156216,7720,7.4,10982,10.5,236706,74330,162376,6.4,20.5,214169,76682,137487,6.6,18.5,22537,2,37,0,5629,5654,34068
1982,70,l) Left Censored,644336,747795,13982734,13914180,35466,4.6,59780,7.8,2044444,573421,1471023,4.1,14.7,1886635,585727,1300908,4.2,13.6,157809,1.1,27.2,0,32075,32167,235994
1983,07,a) 0,6466,6467,26167,13084,6326,195.6,0,0,25807,,,,197.2,0,0,0,0,0,25807,197.2,0,1,,,
1983,07,b) 1,4668,4673,23192,26910,1,0,1480,27.1,6290,,,,23.4,13485,7196,6289,26.7,50.1,-7195,-26.7,46.8,1,946,946,4685
1983,07,c) 2,4190,4191,24390,25834,146,3.2,772,17.1,5321,787,4534,3,20.6,8193,3931,4262,15.2,31.7,-2872,-11.1,41.2,0,514,514,3022
1983,07,d) 3,3370,3379,18794,19556,142,4,569,15.9,4412,548,3864,2.8,22.6,5936,2284,3652,11.7,30.4,-1524,-7.8,45.2,0,374,374,1440
1983,07,e) 4,3364,3372,20115,20313,115,3.3,467,13.2,4785,605,4180,3,23.6,5294,2018,3276,9.9,26.1,-509,-2.5,47.2,0,287,287,1346
1983,07,f) 5,2800,2807,16573,17129,89,3.1,338,11.6,3317,289,3028,1.7,19.4,4420,1785,2635,10.4,25.8,-1103,-6.4,38.8,0,217,217,1248
1983,07,g) 6 to 10,2766,2788,20021,20547,99,3.4,320,11.1,3692,368,3324,1.8,18,4915,1753,3162,8.5,23.9,-1223,-5.9,36,0,195,195,967
1983,07,l) Left Censored,16693,17807,162887,168911,613,3.4,1541,8.5,26795,5044,21751,3,15.9,38907,10490,28417,6.2,23,-12112,-7.1,31.8,0,890,892,4251
1983,10,a) 0,3540,3555,24739,12370,3513,197.6,0,0,24487,24487,0,198,198,0,0,0,0,0,24487,198,0,0,,,
1983,10,b) 1,4170,4221,41176,52111,14,0.3,1896,36.5,8812,353,8459,0.7,16.9,30489,14876,15613,28.5,58.5,-21677,-41.6,33.8,0,1584,1584,12329
1983,10,c) 2,3277,3343,40481,53786,86,2.3,1022,26.8,5534,1019,4515,1.9,10.3,32129,13484,18645,25.1,59.7,-26595,-49.4,20.6,0,828,828,10801
1983,10,d) 3,1800,1837,19793,25235,48,2.4,418,20.8,2279,328,1951,1.3,9,13158,4646,8512,18.4,52.1,-10879,-43.1,18,0,319,319,3678
1983,10,e) 4,1552,1585,20658,25378,54,3.2,307,18,2815,873,1942,3.4,11.1,12233,5289,6944,20.8,48.2,-9418,-37.1,22.2,0,238,238,3434
1983,10,f) 5,1306,1324,17948,21639,38,2.7,205,14.7,1942,245,1697,1.1,9,9359,2191,7168,10.1,43.3,-7417,-34.3,18,0,151,151,1617
1983,10,g) 6 to 10,1161,1303,20435,23654,59,4.3,201,14.7,3301,1211,2090,5.1,14,9778,2345,7433,9.9,41.3,-6477,-27.3,28,0,139,140,1551
1983,10,l) Left Censored,9624,15780,710943,784991,830,5.1,1672,10.4,96996,36836,60160,4.7,12.4,245500,41392,204108,5.3,31.3,-148504,-18.9,24.8,0,595,601,7018
1983,15,a) 0,44455,44474,210044,105022,43115,193.9,0,0,206215,206215,0,196.4,196.4,0,0,0,0,0,206215,196.4,0,0,,,
1983,15,b) 1,31082,31124,208545,219199,17,0,12077,32.1,75223,299,74924,0.1,34.3,94024,50126,43898,22.9,42.9,-18801,-8.6,68.6,0,8308,8308,37868
1983,15,c) 2,29760,29848,227668,244066,1458,4.4,7376,22.5,62815,6089,56726,2.5,25.7,95508,41480,54028,17,39.1,-32693,-13.4,51.4,0,5184,5185,29137
1983,15,d) 3,27393,27434,173323,182844,1461,5,5824,19.8,47171,4943,42228,2.7,25.8,67090,28090,39000,15.4,36.7,-19919,-10.9,51.6,0,3767,3768,19917
1983,15,e) 4,28900,28951,196684,205398,1558,5.1,5649,18.3,52855,5967,46888,2.9,25.7,71517,27933,43584,13.6,34.8,-18662,-9.1,51.4,0,3547,3547,18862
1983,15,f) 5,27043,27161,179459,186883,1467,5.1,4888,17.1,44197,4871,39326,2.6,23.6,59998,21580,38418,11.5,32.1,-15801,-8.5,47.2,0,3008,3008,14894
1983,15,g) 6 to 10,24195,24286,174229,178661,1322,5.2,4003,15.7,43228,4836,38392,2.7,24.2,53108,17024,36084,9.5,29.7,-9880,-5.5,48.4,0,2411,2411,11333
1983,15,l) Left Censored,162499,167907,2202774,2332626,5372,3.1,18513,10.6,389954,43646,346308,1.9,16.7,651795,123077,528718,5.3,27.9,-261841,-11.2,33.4,0,11281,11289,60491
1983,20,a) 0,23916,23993,225859,112930,23620,196.9,0,0,224338,224338,0,198.7,198.7,0,0,0,0,0,224338,198.7,0,0,,,
1983,20,b) 1,20954,21182,276209,286044,79,0.3,5858,24.2,71648,3376,68272,1.2,25,90330,51599,38731,18,31.6,-18682,-6.6,50,0,4480,4482,37805
1983,20,c) 2,19140,19589,352939,367282,508,2.4,3805,17.9,74369,9376,64993,2.6,20.2,102471,47565,54906,13,27.9,-28102,-7.7,40.4,0,2902,2906,30496
1983,20,d) 3,16202,16398,224463,234826,472,2.7,2819,16.1,42196,3493,38703,1.5,18,63280,27830,35450,11.9,26.9,-21084,-8.9,36,0,2151,2152,21402
1983,20,e) 4,15561,15815,247252,252899,412,2.5,2382,14.2,50531,4717,45814,1.9,20,62391,25588,36803,10.1,24.7,-11860,-4.7,40,0,1813,1815,18114
1983,20,f) 5,14139,14389,222470,230985,321,2.1,1781,11.8,36243,6515,29728,2.8,15.7,53400,18823,34577,8.1,23.1,-17157,-7.4,31.4,0,1386,1387,13116
1983,20,g) 6 to 10,13662,14353,286382,300813,433,2.9,1669,11.2,43445,8225,35220,2.7,14.4,72624,30428,42196,10.1,24.1,-29179,-9.7,28.8,0,1171,1174,17918
1983,20,l) Left Censored,147940,203269,16139470,16751492,5135,2.5,14812,7.1,1442009,321450,1120559,1.9,8.6,2667308,557843,2109465,3.3,15.9,-1225299,-7.3,17.2,0,7558,7629,113749
1983,40,a) 0,16574,17329,207120,103560,17034,196.6,0,0,206233,206233,0,199.1,199.1,0,0,0,0,0,206233,199.1,0,0,,,
1983,40,b) 1,13569,16509,426786,395766,99,0.5,4487,23.8,212102,2273,209829,0.6,53.6,149451,21906,127545,5.5,37.8,62651,15.8,75.6,0,3455,3455,15866
1983,40,c) 2,10951,11059,104225,109704,308,2.5,2575,21.1,20200,1705,18495,1.6,18.4,31053,15640,15413,14.3,28.3,-10853,-9.9,36.8,0,1985,1985,12315
1983,40,d) 3,9410,9509,80695,82881,267,2.6,1815,17.7,16096,1500,14596,1.8,19.4,20742,10045,10697,12.1,25,-4646,-5.6,38.8,0,1387,1387,7734
1983,40,e) 4,8879,9041,80902,83776,237,2.5,1528,15.9,14997,2431,12566,2.9,17.9,21216,9122,12094,10.9,25.3,-6219,-7.4,35.8,0,1149,1155,7142
1983,40,f) 5,7604,7756,66900,70148,219,2.7,1140,14,9781,1096,8685,1.6,13.9,16698,6623,10075,9.4,23.8,-6917,-9.9,27.8,0,885,894,5489
1983,40,g) 6 to 10,7203,8490,119776,121947,357,4.1,1084,12.3,17862,3272,14590,2.7,14.6,22395,7774,14621,6.4,18.4,-4533,-3.8,29.2,0,701,720,4527
1983,40,l) Left Censored,57780,96830,3517442,3742637,5951,5.9,12778,12.8,648260,253277,394983,6.8,17.3,1098101,571343,526758,15.3,29.3,-449841,-12,34.6,0,3891,3939,33014
1983,50,a) 0,30264,30588,140525,70263,30168,197.3,0,0,139431,139431,0,198.4,198.4,0,0,0,0,0,139431,198.4,0,0,,,
1983,50,b) 1,26477,27719,172004,187586,172,0.6,6912,22.1,45753,2862,42891,1.5,24.4,76174,26572,49602,14.2,40.6,-30421,-16.2,48.8,0,5200,5207,19200
1983,50,c) 2,23376,24357,180021,187570,685,2.6,4336,16.5,32324,4892,27432,2.6,17.2,47339,22423,24916,12,25.2,-15015,-8,34.4,0,3332,3334,16536
1983,50,d) 3,18431,19097,128042,131996,512,2.5,3002,14.8,22584,2377,20207,1.8,17.1,30622,13703,16919,10.4,23.2,-8038,-6.1,34.2,0,2255,2257,10154
1983,50,e) 4,17963,18981,136744,141614,429,2.1,2596,13,21963,2329,19634,1.6,15.5,32124,13984,18140,9.9,22.7,-10161,-7.2,31,0,1907,1911,10340
1983,50,f) 5,16168,17144,131419,135841,417,2.3,1997,11.2,19891,2078,17813,1.5,14.6,28952,9785,19167,7.2,21.3,-9061,-6.7,29.2,0,1465,1468,7368
1983,50,g) 6 to 10,17999,21931,206859,215277,637,2.8,2335,10.3,28411,4847,23564,2.3,13.2,45700,15515,30185,7.2,21.2,-17289,-8,26.4,0,1371,1398,7858
1983,50,l) Left Censored,157638,247145,4083320,4204524,8363,3.3,20181,8,532688,136164,396524,3.2,12.7,776827,234998,541829,5.6,18.5,-244139,-5.8,25.4,0,8280,8423,58623
1983,52,a) 0,117083,119635,774514,387257,117783,196.9,0,0,768847,768847,0,198.5,198.5,0,0,0,0,0,768847,198.5,0,0,,,
1983,52,b) 1,89509,96677,741221,858008,1136,1,30206,27,160869,18291,142578,2.1,18.7,390306,166050,224256,19.4,45.5,-229437,-26.8,37.4,0,23812,23972,128946
1983,52,c) 2,76134,82167,651704,731011,2749,3.1,18273,20.3,115517,18667,96850,2.6,15.8,274325,109356,164969,15,37.5,-158808,-21.7,31.6,0,14771,14779,85002
1983,52,d) 3,62782,68421,541350,573476,2401,3.3,13269,18.1,93506,17614,75892,3.1,16.3,159402,77663,81739,13.5,27.8,-65896,-11.5,32.6,0,10038,10095,57712
1983,52,e) 4,60566,68275,558118,580995,2409,3.3,11638,16.1,96835,18920,77915,3.3,16.7,144228,69856,74372,12,24.8,-47393,-8.1,33.4,0,8592,8627,50460
1983,52,f) 5,53529,59968,498596,534577,1956,3.1,8944,14.2,82496,17473,65023,3.3,15.4,155805,54763,101042,10.2,29.1,-73309,-13.7,30.8,0,6704,6739,40411
1983,52,g) 6 to 10,58603,79572,780066,810193,3505,4.3,10016,12.2,135366,42206,93160,5.2,16.7,197791,66407,131384,8.2,24.4,-62425,-7.7,33.4,0,5882,5994,34113
1983,52,l) Left Censored,396651,703975,10639120,10776807,31400,4.4,67871,9.4,1534112,502177,1031935,4.7,14.2,1817132,654286,1162846,6.1,16.9,-283020,-2.7,28.4,0,32961,33645,201928
1983,60,a) 0,32812,32939,131406,65703,32025,194.5,0,0,129507,129507,0,197.1,197.1,0,0,0,0,0,129507,197.1,0,0,,,
1983,60,b) 1,24911,25036,150903,144066,37,0.1,7094,24.6,54701,1137,53564,0.8,38,39925,24659,15266,17.1,27.7,14776,10.3,55.4,0,5154,5154,18121
1983,60,c) 2,22316,22477,132748,138108,681,2.8,4636,19,27345,2351,24994,1.7,19.8,37905,20995,16910,15.2,27.4,-10560,-7.6,39.6,0,3401,3402,14674
1983,60,d) 3,18966,19080,104655,104480,587,2.9,3324,16.5,23950,2318,21632,2.2,22.9,24208,11433,12775,10.9,23.2,-258,-0.3,45.8,0,2404,2405,8681
1983,60,e) 4,18256,18320,93978,96110,518,2.7,2902,15.1,17347,2119,15228,2.2,18,22463,10663,11800,11.1,23.4,-5116,-5.4,36,0,2048,2048,7764
1983,60,f) 5,17078,17669,98191,101209,517,2.8,2289,12.6,16976,3998,12978,4,16.8,23793,8888,14905,8.8,23.5,-6817,-6.7,33.6,0,1599,1599,5611
1983,60,g) 6 to 10,16074,17458,132564,131983,689,3.9,1971,11.1,21892,4685,17207,3.5,16.6,21851,8255,13596,6.3,16.6,41,0,33.2,0,1282,1282,4438
1983,60,l) Left Censored,158265,264375,4656326,4678937,12392,4.7,20250,7.6,618151,201645,416506,4.3,13.2,666259,223436,442823,4.8,14.2,-48108,-1,26.4,0,9243,9335,55987
1983,70,a) 0,158780,160041,762679,381340,157262,196.5,0,0,755909,,,,198.2,0,0,0,0,0,755909,198.2,0,1,,,
1983,70,b) 1,127109,130785,893008,948474,517,0.3,33327,22.5,216855,,,,22.9,322183,139399,182784,14.7,34,-105328,-11.1,45.8,1,24483,24504,103740
1983,70,c) 2,109995,114193,875918,905064,3822,3.1,19221,15.8,166244,25131,141113,2.8,18.4,224431,104149,120282,11.5,24.8,-58187,-6.4,36.8,0,14135,14140,76089
1983,70,d) 3,88634,91674,653256,692084,2984,3.1,13632,14.1,121216,15229,105987,2.2,17.5,200302,70579,129723,10.2,28.9,-79086,-11.4,35,0,9685,9693,53382
1983,70,e) 4,82793,86943,695925,727825,2693,3,11224,12.4,118853,19121,99732,2.6,16.3,184814,62872,121942,8.6,25.4,-65961,-9.1,32.6,0,7796,7801,44474
1983,70,f) 5,74710,80204,639697,666509,2712,3.3,8638,10.5,111609,19199,92410,2.9,16.7,167798,50503,117295,7.6,25.2,-56189,-8.5,33.4,0,5992,6013,31615
1983,70,g) 6 to 10,77203,97521,1124421,1145822,3534,3.5,9396,9.4,175923,32725,143198,2.9,15.4,221882,68035,153847,5.9,19.4,-45959,-4,30.8,0,5169,5253,30499
1983,70,l) Left Censored,622319,727190,13852137,13921278,21653,2.9,51999,7,1791015,377183,1413832,2.7,12.9,1942018,492661,1449357,3.5,13.9,-151003,-1,25.8,0,30300,30517,196383
1984,07,a) 0,7322,7324,29019,14510,7264,198.4,0,0,28867,28867,0,198.9,198.9,0,0,0,0,0,28867,198.9,0,0,,,
1984,07,b) 1,4983,4983,25340,25757,6,0.1,1424,24.9,8380,95,8285,0.4,32.5,9035,4902,4133,19,35.1,-655,-2.6,65,0,906,906,3406
1984,07,c) 2,4124,4129,23356,23278,210,4.8,719,16.3,6646,973,5673,4.2,28.6,6372,2891,3481,12.4,27.4,274,1.2,54.8,0,479,479,2092
1984,07,d) 3,3774,3775,25067,24703,193,4.8,605,15.2,6266,624,5642,2.5,25.4,5399,2414,2985,9.8,21.9,867,3.5,43.8,0,378,378,1542
1984,07,e) 4,3066,3068,19232,19023,130,4,454,14.1,4509,456,4053,2.4,23.7,4393,1756,2637,9.2,23.1,116,0.6,46.2,0,274,274,1092
1984,07,f) 5,3151,3165,20238,20165,151,4.6,357,10.9,4369,372,3997,1.8,21.7,4268,1483,2785,7.4,21.2,101,0.5,42.4,0,209,209,1054
1984,07,g) 6 to 10,5248,5279,36940,36757,237,4.4,565,10.4,7819,726,7093,2,21.3,7452,2325,5127,6.3,20.3,367,1,40.6,0,348,348,1457
1984,07,l) Left Censored,15938,17039,170701,166828,563,3.2,1353,7.8,35846,7126,28720,4.3,21.5,28148,8567,19581,5.1,16.9,7698,4.6,33.8,0,724,728,3973
1984,10,a) 0,3311,3317,24258,12129,3306,199.3,0,0,24225,24225,0,199.7,199.7,0,0,0,0,0,24225,199.7,0,0,,,
1984,10,b) 1,2593,2610,21750,23342,8,0.3,930,30.2,6628,256,6372,1.1,28.4,9732,6006,3726,25.7,41.7,-3104,-13.3,56.8,0,716,716,4610
1984,10,c) 2,3266,3313,36394,38742,126,3.3,1019,27.1,9285,1216,8069,3.1,24,13935,8028,5907,20.7,36,-4650,-12,48,0,796,796,6452
1984,10,d) 3,2722,2789,39338,39845,99,3.2,638,20.8,9633,1319,8314,3.3,24.2,10612,5004,5608,12.6,26.6,-979,-2.4,48.4,0,527,527,4026
1984,10,e) 4,1540,1574,17641,18628,57,3.3,315,18.5,4017,288,3729,1.5,21.6,5925,2696,3229,14.5,31.8,-1908,-10.2,43.2,0,242,242,2007
1984,10,f) 5,1364,1397,18440,19510,43,2.9,233,15.6,3227,336,2891,1.7,16.5,5353,2111,3242,10.8,27.4,-2126,-10.9,33,0,168,168,1341
1984,10,g) 6 to 10,2202,2359,37129,38243,83,3.3,361,14.5,6724,1153,5571,3,17.6,9004,3632,5372,9.5,23.5,-2280,-5.9,35.2,0,238,238,2460
1984,10,l) Left Censored,9097,15470,686168,698193,1091,7,1404,9,106057,28054,78003,4,15.2,130019,35297,94722,5.1,18.6,-23962,-3.4,30.4,0,469,470,4275
1984,15,a) 0,60078,60099,296263,148132,59411,197.7,0,0,294109,294109,0,198.5,198.5,0,0,0,0,0,294109,198.5,0,0,,,
1984,15,b) 1,33665,33694,237271,223634,29,0.1,10299,26.3,101289,1260,100029,0.6,45.3,72434,40910,31524,18.3,32.4,28855,12.9,64.8,0,6652,6652,29739
1984,15,c) 2,26681,26722,214967,211906,1551,5.4,5857,20.2,75305,6570,68735,3.1,35.5,68473,34074,34399,16.1,32.3,6832,3.2,64.6,0,3995,3995,25731
1984,15,d) 3,26971,27072,238646,233487,1616,5.6,4788,16.7,76158,6377,69781,2.7,32.6,65544,26470,39074,11.3,28.1,10614,4.5,56.2,0,3192,3192,19935
1984,15,e) 4,26137,26164,192511,183962,1964,7.2,4036,14.9,61679,6775,54904,3.7,33.5,45097,18787,26310,10.2,24.5,16582,9,49,0,2558,2558,13530
1984,15,f) 5,27695,27745,218323,207900,2296,8.1,4010,14.1,69347,8187,61160,3.9,33.4,49674,18968,30706,9.1,23.9,19673,9.5,47.8,0,2514,2514,13154
1984,15,g) 6 to 10,48989,49199,385505,369589,3919,7.8,6665,13.2,116364,13610,102754,3.7,31.5,85898,28623,57275,7.7,23.2,30466,8.3,46.4,0,3990,3990,19091
1984,15,l) Left Censored,153143,158478,2284527,2241655,6698,4.1,15267,9.4,532817,63239,469578,2.8,23.8,449387,93281,356106,4.2,20,83430,3.8,40,0,9151,9167,47923
1984,20,a) 0,27541,27639,273426,136713,27501,199,0,0,272651,272651,0,199.4,199.4,0,0,0,0,0,272651,199.4,0,0,,,
1984,20,b) 1,19285,19448,269136,252192,81,0.4,4520,20.8,91986,3204,88782,1.3,36.5,57338,34283,23055,13.6,22.7,34648,13.8,45.4,0,3347,3348,25290
1984,20,c) 2,18003,18237,294154,282579,682,3.5,3472,17.6,82746,10771,71975,3.8,29.3,59368,33753,25615,11.9,21,23378,8.3,42,0,2654,2656,25119
1984,20,d) 3,17115,17614,381065,368971,576,3.1,2535,13.6,88038,8952,79086,2.4,23.9,63722,26723,36999,7.2,17.3,24316,6.6,34.6,0,1915,1916,16503
1984,20,e) 4,14696,14909,245427,233684,544,3.5,2013,12.9,61006,5490,55516,2.3,26.1,37578,17862,19716,7.6,16.1,23428,10,32.2,0,1532,1532,13276
1984,20,f) 5,14376,14642,265303,255746,464,3,1649,10.8,63257,6989,56268,2.7,24.7,44037,16557,27480,6.5,17.2,19220,7.5,34.4,0,1199,1199,10881
1984,20,g) 6 to 10,25888,26929,554515,535114,875,3.1,2813,10.1,114715,13085,101630,2.4,21.4,76181,28072,48109,5.2,14.2,38534,7.2,28.4,0,1903,1907,16509
1984,20,l) Left Censored,141458,196098,16884629,16506516,5732,2.9,13055,6.5,2268725,427007,1841718,2.6,13.7,1542150,511240,1030910,3.1,9.3,726575,4.4,18.6,0,6130,6221,78779
1984,40,a) 0,19259,19345,112483,56242,19242,198.9,0,0,112124,,,,199.4,0,0,0,0,0,112124,199.4,0,1,,,
1984,40,b) 1,12862,14524,246113,262603,452,2.8,3592,22.2,57420,,,,21.9,89980,14178,75802,5.4,34.3,-32560,-12.4,43.8,1,2633,2633,10725
1984,40,c) 2,11351,14921,413706,420492,1200,7.6,2682,17.1,80521,44950,35571,10.7,19.1,93879,21256,72623,5.1,22.3,-13358,-3.2,38.2,0,1872,1874,11322
1984,40,d) 3,9468,9557,102141,101838,327,3.2,1802,17.5,22428,2475,19953,2.4,22,21869,11732,10137,11.5,21.5,559,0.5,43,0,1337,1337,9259
1984,40,e) 4,8285,8385,83310,81983,331,3.7,1459,16.3,19402,2699,16703,3.3,23.7,16718,9136,7582,11.1,20.4,2684,3.3,40.8,0,1050,1052,6850
1984,40,f) 5,7982,8151,81003,81067,306,3.6,1229,14.3,16405,1849,14556,2.3,20.2,16709,7839,8870,9.7,20.6,-304,-0.4,40.4,0,906,907,6044
1984,40,g) 6 to 10,13474,15036,192361,188100,718,4.6,1967,12.6,38762,5558,33204,3,20.6,30356,13381,16975,7.1,16.1,8406,4.5,32.2,0,1272,1307,8327
1984,40,l) Left Censored,54029,95317,3537676,3490719,6944,7.3,7777,8.1,606439,231567,374872,6.6,17.4,512629,150023,362606,4.3,14.7,93810,2.7,29.4,0,3163,3250,27442
1984,50,a) 0,33013,33407,164166,82083,33283,199.3,0,0,163823,163823,0,199.6,199.6,0,0,0,0,0,163823,199.6,0,0,,,
1984,50,b) 1,24594,25174,159230,151033,255,0.9,5586,20,52528,4222,48306,2.8,34.8,35734,20419,15315,13.5,23.7,16794,11.1,47.4,0,3976,3978,14956
1984,50,c) 2,22931,23958,177917,174787,913,3.6,4250,16.5,44643,7510,37133,4.3,25.5,38038,18931,19107,10.8,21.8,6605,3.7,43.6,0,3128,3142,13363
1984,50,d) 3,20923,21975,185370,182450,739,3.2,3086,13.3,38388,4259,34129,2.3,21,32432,15434,16998,8.5,17.8,5956,3.2,35.6,0,2274,2277,10644
1984,50,e) 4,16729,17436,133614,130758,545,3,2196,12,27676,3528,24148,2.7,21.2,22030,10049,11981,7.7,16.8,5646,4.4,33.6,0,1581,1583,6694
1984,50,f) 5,16434,17480,141096,138805,543,3,2034,11.2,27323,3467,23856,2.5,19.7,22784,10149,12635,7.3,16.4,4539,3.3,32.8,0,1454,1454,7307
1984,50,g) 6 to 10,31756,36700,348139,342374,1232,3.3,3613,9.5,63330,9531,53799,2.8,18.5,52044,21755,30289,6.4,15.2,11286,3.3,30.4,0,2138,2150,10925
1984,50,l) Left Censored,149748,239244,4196841,4139232,9932,4.1,18149,7.5,653606,190776,462830,4.6,15.8,538993,189215,349778,4.6,13,114613,2.8,26,0,6744,6849,51336
1984,52,a) 0,123928,126000,824928,412464,125490,199.2,0,0,823368,823368,0,199.6,199.6,0,0,0,0,0,823368,199.6,0,0,,,
1984,52,b) 1,87794,90848,717853,747773,876,0.8,28946,27.5,182664,13525,169139,1.8,24.4,240142,144461,95681,19.3,32.1,-57478,-7.7,48.8,0,22237,22249,111923
1984,52,c) 2,73238,80239,685038,713850,3259,3.7,19243,21.8,140129,29158,110971,4.1,19.6,196515,108351,88164,15.2,27.5,-56386,-7.9,39.2,0,13994,14102,77333
1984,52,d) 3,64889,70872,619836,635344,2607,3.4,13778,18,114499,20506,93993,3.2,18,145191,77813,67378,12.2,22.9,-30692,-4.9,36,0,10196,10218,56140
1984,52,e) 4,54623,60121,521104,530618,2378,3.7,10670,16.6,96626,20617,76009,3.9,18.2,115481,59059,56422,11.1,21.8,-18855,-3.6,36.4,0,7516,7573,40402
1984,52,f) 5,53278,60697,532800,541939,2302,3.6,9870,15.3,97480,20379,77101,3.8,18,115987,55633,60354,10.3,21.4,-18507,-3.4,36,0,6781,6832,37109
1984,52,g) 6 to 10,100629,128093,1256442,1266230,5432,4.1,17134,12.8,217064,52983,164081,4.2,17.1,237424,99110,138314,7.8,18.8,-20360,-1.7,34.2,0,10421,10534,54712
1984,52,l) Left Censored,364852,676074,10925027,10783255,32570,4.7,61053,8.8,1668390,540430,1127960,5,15.5,1386713,536294,850419,5,12.9,281677,2.6,25.8,0,28503,28775,156485
1984,60,a) 0,37922,38180,162429,81215,37933,198.7,0,0,161856,161856,0,199.3,199.3,0,0,0,0,0,161856,199.3,0,0,,,
1984,60,b) 1,26167,26332,140972,136661,76,0.3,6339,21.4,47892,2363,45529,1.7,35,38394,22055,16339,16.1,28.1,9498,6.9,56.2,0,4374,4374,16475
1984,60,c) 2,21284,21396,149783,148873,806,3.5,4228,18.2,33389,3717,29672,2.5,22.4,30775,16110,14665,10.8,20.7,2614,1.7,41.4,0,3011,3012,12412
1984,60,d) 3,19751,19965,134776,133832,788,3.7,3264,15.4,28934,3972,24962,3,21.6,26812,12830,13982,9.6,20,2122,1.6,40,0,2424,2424,9715
1984,60,e) 4,17251,17377,102402,100751,788,4.3,2520,13.8,22003,2494,19509,2.5,21.8,18693,9880,8813,9.8,18.6,3310,3.2,37.2,0,1793,1793,7567
1984,60,f) 5,16797,16884,94611,94160,758,4.3,2244,12.7,18979,2891,16088,3.1,20.2,18284,8757,9527,9.3,19.4,695,0.8,38.8,0,1617,1617,6305
1984,60,g) 6 to 10,30901,32861,236641,233362,1394,4.1,3728,11,44189,7451,36738,3.2,18.9,37182,15760,21422,6.8,15.9,7007,3,31.8,0,2381,2381,9311
1984,60,l) Left Censored,149557,258080,4795001,4723937,11541,4.4,18254,7,715412,238837,476575,5.1,15.1,573864,161574,412290,3.4,12.1,141548,3,24.2,0,8107,8197,45486
1984,70,a) 0,190996,192193,911804,455902,190988,198.7,0,0,907054,,,,199,0,0,0,0,0,907054,199,0,1,,,
1984,70,b) 1,126262,128078,831894,808190,735,0.5,31235,21.7,255563,,,,31.6,204273,117199,87074,14.5,25.3,51290,6.3,50.6,1,21361,21367,85923
1984,70,c) 2,109538,113223,873441,879798,3923,3.2,20657,16.9,198165,27787,170378,3.2,22.5,208723,110781,97942,12.6,23.7,-10558,-1.2,45,0,14261,14306,80478
1984,70,d) 3,98358,102602,894740,887403,3367,3.1,14821,13.7,179904,24619,155285,2.8,20.3,164518,79838,84680,9,18.5,15386,1.8,37,0,10129,10160,58806
1984,70,e) 4,81168,84203,661941,656016,3018,3.4,10715,12.2,127407,14833,112574,2.3,19.4,116238,52670,63568,8,17.7,11169,1.7,35.4,0,7128,7133,36668
1984,70,f) 5,76335,80400,661007,660356,2850,3.4,9517,11.4,122623,15570,107053,2.4,18.6,121526,55062,66464,8.3,18.4,1097,0.2,36.8,0,6246,6259,34377
1984,70,g) 6 to 10,142882,169116,1797627,1783670,6667,3.8,16241,9.4,306727,50137,256590,2.8,17.2,281103,98523,182580,5.5,15.8,25624,1.4,31.6,0,9106,9172,49491
1984,70,l) Left Censored,594011,701921,14112896,13956521,21760,3,49028,6.9,1963746,503606,1460140,3.6,14.1,1657160,451319,1205841,3.2,11.9,306586,2.2,23.8,0,27264,27502,181167
1985,07,a) 0,8467,8557,36875,18438,8486,198.3,0,0,36396,36396,0,197.4,197.4,0,0,0,0,0,36396,197.4,0,0,,,
1985,07,b) 1,5752,5755,30820,31310,3,0,1458,22.3,10770,,,,34.4,11318,6334,4984,20.2,36.1,-548,-1.7,68.8,1,975,975,3697
1985,07,c) 2,4249,4251,25016,24977,178,3.9,819,17.8,7392,552,6840,2.2,29.6,7101,3333,3768,13.3,28.4,291,1.2,56.8,0,574,574,2503
1985,07,d) 3,3707,3712,24768,24019,134,3.4,549,14,7366,,,,30.7,5830,2110,3720,8.8,24.3,1536,6.4,48.6,1,381,381,1552
1985,07,e) 4,3428,3428,24938,24943,144,4,477,13.3,5639,460,5179,1.8,22.6,5585,1983,3602,8,22.4,54,0.2,44.8,0,326,326,1401
1985,07,f) 5,2892,2893,19417,19336,153,5.1,336,11.3,4410,483,3927,2.5,22.8,4107,1457,2650,7.5,21.2,303,1.6,42.4,0,225,225,1110
1985,07,g) 6 to 10,7864,7904,55492,56335,331,4.1,881,10.8,12173,1193,10980,2.1,21.6,13764,5210,8554,9.2,24.4,-1591,-2.8,43.2,0,573,573,3976
1985,07,l) Left Censored,15050,16147,164030,166046,468,2.8,1341,8.1,27979,3936,24043,2.4,16.9,31997,8059,23938,4.9,19.3,-4018,-2.4,33.8,0,816,816,4297
1985,10,a) 0,3450,3455,25482,12741,3431,198.6,0,0,25224,25224,0,198,198,0,0,0,0,0,25224,198,0,0,,,
1985,10,b) 1,2572,2585,27826,27027,12,0.4,715,24.2,9218,1049,8169,3.9,34.1,7494,3942,3552,14.6,27.7,1724,6.4,55.4,0,547,547,2975
1985,10,c) 2,2070,2091,18556,20069,82,3.5,588,25,4273,338,3935,1.7,21.3,7256,4245,3011,21.2,36.2,-2983,-14.9,42.6,0,454,454,3185
1985,10,d) 3,2772,2827,31410,33962,118,3.8,626,20.3,6160,834,5326,2.5,18.1,11297,5336,5961,15.7,33.3,-5137,-15.2,36.2,0,503,505,3967
1985,10,e) 4,2374,2435,33825,36213,79,3,442,16.9,6573,915,5658,2.5,18.2,10766,4728,6038,13.1,29.7,-4193,-11.5,36.4,0,330,330,3312
1985,10,f) 5,1384,1405,16076,16913,53,3.6,227,15.3,3292,258,3034,1.5,19.5,5028,1615,3413,9.5,29.7,-1736,-10.2,39,0,164,164,1288
1985,10,g) 6 to 10,3252,3501,53080,54735,123,3.4,443,12.1,8694,824,7870,1.5,15.9,11869,3836,8033,7,21.7,-3175,-5.8,31.8,0,290,290,2373
1985,10,l) Left Censored,8580,14777,654546,669496,731,4.8,1350,9,84918,19043,65875,2.8,12.7,114811,33995,80816,5.1,17.1,-29893,-4.4,25.4,0,462,473,5569
1985,15,a) 0,66870,66895,326143,163072,66200,197.9,0,0,323694,323694,0,198.5,198.5,0,0,0,0,0,323694,198.5,0,0,,,
1985,15,b) 1,46123,46150,345677,324341,36,0.1,13074,24.6,147621,1219,146402,0.4,45.5,102208,52592,49616,16.2,31.5,45413,14,63,0,8578,8578,37513
1985,15,c) 2,28529,28603,223475,230086,1523,4.9,6278,20.2,70969,7315,63654,3.2,30.8,82952,37741,45211,16.4,36.1,-11983,-5.3,61.6,0,4449,4449,29042
1985,15,d) 3,23690,23740,210621,212985,1239,4.9,4350,17.2,59564,5465,54099,2.6,28,64848,27164,37684,12.8,30.4,-5284,-2.4,56,0,3072,3072,19719
1985,15,e) 4,24318,24415,233691,236017,1243,4.8,3987,15.5,66496,4799,61697,2,28.2,71253,23819,47434,10.1,30.2,-4757,-2,56.4,0,2769,2769,17345
1985,15,f) 5,24173,24199,194244,193463,1502,6,3626,14.4,53057,5009,48048,2.6,27.4,51833,19261,32572,10,26.8,1224,0.6,53.6,0,2461,2461,14114
1985,15,g) 6 to 10,71581,71831,594312,598434,4654,6.3,10370,13.9,151490,15904,135586,2.7,25.3,161397,53688,107709,9,27,-9907,-1.7,50.6,0,6653,6654,38157
1985,15,l) Left Censored,144550,149822,2309896,2297010,5389,3.5,14921,9.7,523067,84608,438459,3.7,22.8,497449,136295,361154,5.9,21.7,25618,1.1,43.4,0,9655,9663,62286
1985,20,a) 0,29978,30103,281598,140799,29934,198.9,0,0,280653,280653,0,199.3,199.3,0,0,0,0,0,280653,199.3,0,0,,,
1985,20,b) 1,23827,24083,397348,384398,165,0.6,3902,15,103166,12296,90870,3.2,26.8,76566,36424,40142,9.5,19.9,26600,6.9,39.8,0,2869,2869,23880
1985,20,c) 2,16600,16789,252839,260390,546,3,3055,16.9,59368,7047,52321,2.7,22.8,73900,36895,37005,14.2,28.4,-14532,-5.6,45.6,0,2426,2427,26075
1985,20,d) 3,16023,16269,290062,291903,536,3.1,2482,14.4,59553,7423,52130,2.5,20.4,62860,28578,34282,9.8,21.5,-3307,-1.1,40.8,0,1941,1948,21777
1985,20,e) 4,15655,16225,395476,398978,463,2.7,1936,11.4,65196,8513,56683,2.1,16.3,72366,33303,39063,8.3,18.1,-7170,-1.8,32.6,0,1523,1523,17836
1985,20,f) 5,13539,13785,240318,242237,417,2.9,1604,11.2,43332,4329,39003,1.8,17.9,47406,19117,28289,7.9,19.6,-4074,-1.7,35.8,0,1229,1232,12988
1985,20,g) 6 to 10,37389,38757,811428,819368,1161,2.9,4069,10.1,136827,16307,120520,2,16.7,153362,61519,91843,7.5,18.7,-16535,-2,33.4,0,2950,2956,36683
1985,20,l) Left Censored,133070,186953,16537039,16648604,5067,2.6,13824,7.2,1685270,355044,1330226,2.1,10.1,1904409,668932,1235477,4,11.4,-219139,-1.3,20.2,0,6905,6978,126433
1985,40,a) 0,20456,20507,115868,57934,20368,198.6,0,0,115416,115416,0,199.2,199.2,0,0,0,0,0,115416,199.2,0,0,,,
1985,40,b) 1,15161,15248,123637,124245,50,0.3,3902,22.6,38230,,,,30.8,38837,16553,22284,13.3,31.3,-607,-0.5,61.6,1,2924,2924,12283
1985,40,c) 2,10689,12698,269980,260704,767,5.6,2570,18.8,74646,22660,51986,8.7,28.6,55772,17920,37852,6.9,21.4,18874,7.2,42.8,0,1892,1892,10202
1985,40,d) 3,9850,14244,359688,386844,1258,8.6,1925,13.2,61372,,,,15.9,115540,13930,101610,3.6,29.9,-54168,-14,31.8,1,1454,1457,10382
1985,40,e) 4,8435,8542,100911,101258,311,3.4,1339,14.8,18830,1303,17527,1.3,18.6,19614,9352,10262,9.2,19.4,-784,-0.8,37.2,0,1039,1039,7430
1985,40,f) 5,7424,7545,81552,82030,291,3.7,1152,14.5,16081,1276,14805,1.6,19.6,17470,7803,9667,9.5,21.3,-1389,-1.7,39.2,0,854,855,6056
1985,40,g) 6 to 10,19501,21488,278304,275771,1098,4.9,2810,12.6,54508,10895,43613,4,19.8,49671,20767,28904,7.5,18,4837,1.8,36,0,1989,1992,14040
1985,40,l) Left Censored,53267,94558,3584992,3579973,4445,4.6,7867,8.2,447458,95682,351776,2.7,12.5,437215,149849,287366,4.2,12.2,10243,0.3,24.4,0,3270,3503,44090
1985,50,a) 0,34597,34914,166840,83420,34749,199.1,0,0,166226,166226,0,199.3,199.3,0,0,0,0,0,166226,199.3,0,0,,,
1985,50,b) 1,27354,28457,196205,189607,305,1,5566,17.8,58164,5335,52829,2.8,30.7,44100,22007,22093,11.6,23.3,14064,7.4,46.6,0,4045,4045,15630
1985,50,c) 2,21342,22038,156388,157462,889,3.8,3841,16.3,39846,5511,34335,3.5,25.3,41592,20618,20974,13.1,26.4,-1746,-1.1,50.6,0,2963,2966,15691
1985,50,d) 3,20371,21467,176058,176807,739,3.3,3216,14.2,35712,5005,30707,2.8,20.2,37262,18950,18312,10.7,21.1,-1550,-0.9,40.4,0,2368,2373,13544
1985,50,e) 4,18994,20126,185896,185079,637,3,2500,11.9,33853,4541,29312,2.5,18.3,32753,14122,18631,7.6,17.7,1100,0.6,35.4,0,1848,1853,8896
1985,50,f) 5,15412,16250,131804,132621,573,3.4,1867,11.1,22027,2576,19451,1.9,16.6,23691,10544,13147,8,17.9,-1664,-1.3,33.2,0,1383,1389,7613
1985,50,g) 6 to 10,44526,50488,483125,486581,1554,3,5223,10,78331,10034,68297,2.1,16.1,85139,38621,46518,7.9,17.5,-6808,-1.4,32.2,0,3344,3360,21085
1985,50,l) Left Censored,140404,229486,4142624,4160100,9379,4,18379,7.9,567445,151947,415498,3.7,13.6,602347,234418,367929,5.6,14.5,-34902,-0.9,27.2,0,7486,7597,63969
1985,52,a) 0,125126,127613,870368,435184,126994,199,0,0,867489,867489,0,199.3,199.3,0,0,0,0,0,867489,199.3,0,0,,,
1985,52,b) 1,95708,98891,786264,812788,1164,1,27572,24.5,197598,18125,179473,2.2,24.3,247199,137559,109640,16.9,30.4,-49601,-6.1,48.6,0,21887,21895,111701
1985,52,c) 2,71364,74795,640166,678768,3288,4,18732,22.6,131122,23098,108024,3.4,19.3,206239,108952,97287,16.1,30.4,-75117,-11.1,38.6,0,14875,14912,85711
1985,52,d) 3,61602,68441,626171,653950,2850,3.8,14478,19.5,113005,20850,92155,3.2,17.3,168110,90704,77406,13.9,25.7,-55105,-8.4,34.6,0,10803,10981,64083
1985,52,e) 4,56524,62503,590895,604898,2374,3.6,10721,16.1,102622,19653,82969,3.2,17,131403,63857,67546,10.6,21.7,-28781,-4.7,34,0,7802,7855,43369
1985,52,f) 5,48045,53533,497211,509309,2202,3.9,8836,15.6,86978,20797,66181,4.1,17.1,111471,54042,57429,10.6,21.9,-24493,-4.8,34.2,0,6433,6517,38340
1985,52,g) 6 to 10,137171,173071,1758086,1772591,7844,4.3,23930,13.2,305160,86762,218398,4.9,17.2,335805,159823,175982,9,18.9,-30645,-1.7,34.4,0,15619,15852,93594
1985,52,l) Left Censored,332824,642812,10999039,10957430,32327,4.9,65391,9.9,1630259,548241,1082018,5,14.9,1547912,680613,867299,6.2,14.1,82347,0.8,28.2,0,29382,29863,193969
1985,60,a) 0,40534,41256,185453,92727,40983,198.7,0,0,184721,184721,0,199.2,199.2,0,0,0,0,0,184721,199.2,0,0,,,
1985,60,b) 1,30452,30822,185584,177931,106,0.3,7068,20.4,65364,5949,59415,3.3,36.7,48552,26762,21790,15,27.3,16812,9.4,54.6,0,5042,5042,20144
1985,60,c) 2,22363,22541,132902,134760,837,3.4,4390,18,32611,3477,29134,2.6,24.2,35490,18249,17241,13.5,26.3,-2879,-2.1,48.4,0,3236,3236,13972
1985,60,d) 3,18779,18925,144661,147237,767,3.8,3249,16.1,27092,3278,23814,2.2,18.4,31986,16624,15362,11.3,21.7,-4894,-3.3,36.8,0,2407,2407,12065
1985,60,e) 4,17806,18173,137258,139261,780,4.1,2611,13.7,30394,5584,24810,4,21.8,34705,13696,21009,9.8,24.9,-4311,-3.1,43.6,0,1881,1881,9637
1985,60,f) 5,15732,15874,105216,104426,610,3.7,2190,13.2,23569,1681,21888,1.6,22.6,22200,10110,12090,9.7,21.3,1369,1.3,42.6,0,1601,1601,6397
1985,60,g) 6 to 10,44325,46465,325545,325153,2159,4.5,5477,11.4,58990,8528,50462,2.6,18.1,59117,25707,33410,7.9,18.2,-127,-0.1,36.2,0,3797,3801,17097
1985,60,l) Left Censored,141347,252366,4797258,4773432,12214,4.8,19072,7.5,666891,174702,492189,3.7,14,618139,205829,412310,4.3,12.9,48752,1.1,25.8,0,8824,8970,65150
1985,70,a) 0,179924,181560,934093,467047,180401,198.7,0,0,928376,928376,0,198.8,198.8,0,0,0,0,0,928376,198.8,0,0,,,
1985,70,b) 1,159415,161423,1072738,1026697,768,0.4,29589,16.7,327647,24951,302696,2.4,31.9,229470,110919,118551,10.8,22.4,98177,9.5,44.8,0,19969,19976,78683
1985,70,c) 2,109360,111685,820095,822580,4892,4.1,20075,16.8,193256,31060,162196,3.8,23.5,195537,93643,101894,11.4,23.8,-2281,-0.3,47,0,14678,14688,71865
1985,70,d) 3,98535,102318,857912,865195,3829,3.6,14877,13.8,177034,25134,151900,2.9,20.5,191999,93962,98037,10.9,22.2,-14965,-1.7,41,0,10521,10557,66480
1985,70,e) 4,90107,94505,887068,892143,3440,3.5,11764,11.9,155337,20985,134352,2.4,17.4,165893,74018,91875,8.3,18.6,-10556,-1.2,34.8,0,8086,8119,48805
1985,70,f) 5,75043,78092,649741,654258,2723,3.4,8927,11,117609,13882,103727,2.1,18,127012,55399,71613,8.5,19.4,-9403,-1.4,36,0,6262,6282,40108
1985,70,g) 6 to 10,204523,234797,2447275,2446077,8861,3.7,23890,9.9,417405,73623,343782,3,17.1,416778,184871,231907,7.6,17,627,0.1,34,0,14570,14714,102525
1985,70,l) Left Censored,571953,682125,15001035,14967032,20613,3,48750,7,1932433,435410,1497023,2.9,12.9,1872563,586034,1286529,3.9,12.5,59870,0.4,25,0,28874,29076,253509
1986,07,a) 0,8933,8933,36302,18151,8895,199.1,0,0,36231,36231,0,199.6,199.6,0,0,0,0,0,36231,199.6,0,0,,,
1986,07,b) 1,6563,6652,37620,37231,35,0.5,1733,22.8,13896,1052,12844,2.8,37.3,12502,6294,6208,16.9,33.6,1394,3.7,67.2,0,1123,1123,4114
1986,07,c) 2,4930,4944,29530,30176,192,3.6,937,17.5,7929,957,6972,3.2,26.3,9018,4693,4325,15.6,29.9,-1089,-3.6,52.6,0,656,656,3673
1986,07,d) 3,3708,3709,23380,24203,157,3.9,667,16.8,5524,560,4964,2.3,22.8,6995,3247,3748,13.4,28.9,-1471,-6.1,45.6,0,455,455,2065
1986,07,e) 4,3354,3359,23035,23902,150,4.2,476,13.5,5306,708,4598,3,22.2,6951,2470,4481,10.3,29.1,-1645,-6.9,44.4,0,332,332,1625
1986,07,f) 5,3114,3114,23516,24235,108,3.3,404,12.3,4713,348,4365,1.4,19.4,6115,1981,4134,8.2,25.2,-1402,-5.8,38.8,0,288,288,1457
1986,07,g) 6 to 10,10008,10044,72214,73562,412,4,1136,10.9,13982,1456,12526,2,19,16616,5345,11271,7.3,22.6,-2634,-3.6,38,0,730,730,3804
1986,07,l) Left Censored,14211,15261,165877,164961,537,3.4,1372,8.7,31029,5509,25520,3.3,18.8,28956,9706,19250,5.9,17.6,2073,1.2,35.2,0,805,807,3930
1986,10,a) 0,2785,2786,24671,12336,2777,199.4,0,0,24621,24621,0,199.6,199.6,0,0,0,0,0,24621,199.6,0,0,,,
1986,10,b) 1,2522,2528,22120,23600,39,1.3,926,31,7181,1035,6146,4.4,30.4,10050,6582,3468,27.9,42.6,-2869,-12.2,60.8,0,765,765,5555
1986,10,c) 2,2016,2030,21516,25058,71,3.1,597,25.9,3723,342,3381,1.4,14.9,10673,4133,6540,16.5,42.6,-6950,-27.7,29.8,0,497,497,3210
1986,10,d) 3,1709,1728,15204,16907,67,3.5,419,21.9,2732,514,2218,3,16.2,6002,2677,3325,15.8,35.5,-3270,-19.3,32.4,0,341,341,2181
1986,10,e) 4,2299,2365,25192,28314,91,3.5,544,20.9,4271,745,3526,2.6,15.1,10463,3959,6504,14,37,-6192,-21.9,30.2,0,456,456,3232
1986,10,f) 5,1974,2017,25743,29469,62,2.8,454,20.4,4127,451,3676,1.5,14,11480,5123,6357,17.4,39,-7353,-25,28,0,361,361,3752
1986,10,g) 6 to 10,4101,4379,56923,63864,172,3.7,682,14.7,8529,2228,6301,3.5,13.4,22355,6932,15423,10.9,35,-13826,-21.6,26.8,0,512,512,4137
1986,10,l) Left Censored,8040,13890,589875,621506,603,4.2,1471,10.3,74197,20834,53363,3.4,11.9,137221,36213,101008,5.8,22.1,-63024,-10.2,23.8,0,483,484,5088
1986,15,a) 0,69685,69692,359508,179754,69423,199.2,0,0,358213,358213,0,199.3,199.3,0,0,0,0,0,358213,199.3,0,0,,,
1986,15,b) 1,50311,50330,358095,342444,185,0.3,15640,26.7,150359,12120,138239,3.5,43.9,115710,64103,51607,18.7,33.8,34649,10.1,67.6,0,10576,10576,46854
1986,15,c) 2,38870,38924,312652,330858,1972,4.6,8645,20.3,94905,12125,82780,3.7,28.7,128917,63372,65545,19.2,39,-34012,-10.3,57.4,0,6154,6155,40951
1986,15,d) 3,24465,24506,205444,214523,1159,4.4,5024,18.9,56158,5487,50671,2.6,26.2,73218,31488,41730,14.7,34.1,-17060,-7.9,52.4,0,3577,3577,23658
1986,15,e) 4,20909,20960,196177,204408,928,4.2,3567,16,48387,5217,43170,2.6,23.7,64000,23402,40598,11.4,31.3,-15613,-7.6,47.4,0,2601,2601,17850
1986,15,f) 5,21712,21808,225614,229041,1046,4.5,3560,15.4,60595,4409,56186,1.9,26.5,66992,21416,45576,9.4,29.2,-6397,-2.7,53,0,2495,2496,15805
1986,15,g) 6 to 10,88142,88433,762383,775653,5122,5.6,12567,13.6,181143,19826,161317,2.6,23.4,206813,63103,143710,8.1,26.7,-25670,-3.3,46.8,0,8323,8324,46501
1986,15,l) Left Censored,134895,139970,2250591,2277613,5034,3.5,14386,9.9,441402,61752,379650,2.7,19.4,493163,113487,379676,5,21.7,-51761,-2.3,38.8,0,9589,9598,54473
1986,20,a) 0,29137,29198,287411,143706,29122,199.5,0,0,286436,286436,0,199.3,199.3,0,0,0,0,0,286436,199.3,0,0,,,
1986,20,b) 1,24395,24539,368517,325370,882,3.2,6084,22.3,169465,86295,83170,26.5,52.1,80589,47531,33058,14.6,24.8,88876,27.3,49.6,0,4597,4597,35589
1986,20,c) 2,19345,19738,374439,384924,595,2.7,4748,21.7,79600,13276,66324,3.4,20.7,98808,52578,46230,13.7,25.7,-19208,-5,41.4,0,3878,3880,43887
1986,20,d) 3,14467,14711,250092,253700,464,2.9,2457,15.6,52198,9029,43169,3.6,20.6,57905,28424,29481,11.2,22.8,-5707,-2.2,41.2,0,1929,1930,21417
1986,20,e) 4,14226,14494,272121,281616,399,2.6,2121,13.8,45521,4734,40787,1.7,16.2,63524,26925,36599,9.6,22.6,-18003,-6.4,32.4,0,1666,1668,19803
1986,20,f) 5,14146,14693,388818,388783,352,2.3,1821,11.8,70433,5270,65163,1.4,18.1,69736,30303,39433,7.8,17.9,697,0.2,35.8,0,1361,1365,17375
1986,20,g) 6 to 10,46793,48544,1049325,1062366,1380,2.7,5376,10.6,174457,26745,147712,2.5,16.4,198334,73836,124498,7,18.7,-23877,-2.3,32.8,0,3995,4004,48015
1986,20,l) Left Censored,125028,178452,16000780,16259377,5499,3,13617,7.5,1547105,397591,1149514,2.4,9.5,2043244,675187,1368057,4.2,12.6,-496139,-3.1,19,0,7112,7195,166465
1986,40,a) 0,21336,21495,129241,64621,21433,199.4,0,0,129073,129073,0,199.7,199.7,0,0,0,0,0,129073,199.7,0,0,,,
1986,40,b) 1,15798,16018,127882,120613,363,2,4597,25.2,47656,11949,35707,9.9,39.5,32068,18181,13887,15.1,26.6,15588,12.9,53.2,0,3360,3361,13817
1986,40,c) 2,12651,12762,110084,116768,440,3.1,2800,20,25850,2492,23358,2.1,22.1,38674,22425,16249,19.2,33.1,-12824,-11,44.2,0,2170,2170,16482
1986,40,d) 3,9104,11458,252074,261946,721,6,1929,15.9,42959,14096,28863,5.4,16.4,62033,14686,47347,5.6,23.7,-19074,-7.3,32.8,0,1456,1456,9051
1986,40,e) 4,8597,12685,354174,357990,527,3.9,2124,15.7,51982,9882,42100,2.8,14.5,59475,19627,39848,5.5,16.6,-7493,-2.1,29,0,1248,1248,9452
1986,40,f) 5,7480,7636,99717,101915,254,3.1,1213,14.9,16642,1407,15235,1.4,16.3,20773,8255,12518,8.1,20.4,-4131,-4.1,32.6,0,942,942,6465
1986,40,g) 6 to 10,24674,27647,366507,366969,1861,6.5,3673,12.8,67492,12507,54985,3.4,18.4,68029,28376,39653,7.7,18.5,-537,-0.1,36.8,0,2629,2632,18792
1986,40,l) Left Censored,49055,90921,3581832,3577166,4746,5.1,7409,8,452122,110437,341685,3.1,12.6,440669,115625,325044,3.2,12.3,11453,0.3,24.6,0,3255,3395,33285
1986,50,a) 0,35275,35543,183327,91664,35464,199.6,0,0,182820,182820,0,199.4,199.4,0,0,0,0,0,182820,199.4,0,0,,,
1986,50,b) 1,29017,29463,199552,183354,1390,4.3,6464,20.1,79415,30463,48952,16.6,43.3,46094,25478,20616,13.9,25.1,33321,18.2,50.2,0,4747,4748,18784
1986,50,c) 2,23537,24842,188844,192413,1048,3.9,4431,16.6,42694,8556,34138,4.4,22.2,48736,24275,24461,12.6,25.3,-6042,-3.1,44.4,0,3392,3395,18317
1986,50,d) 3,18750,19510,151032,153913,706,3.4,3093,14.9,31890,5001,26889,3.2,20.7,37312,17938,19374,11.7,24.2,-5422,-3.5,41.4,0,2415,2416,12660
1986,50,e) 4,18265,19517,172860,173816,721,3.5,2566,12.5,33580,6616,26964,3.8,19.3,35366,14653,20713,8.4,20.3,-1786,-1,38.6,0,1923,1923,10486
1986,50,f) 5,17308,18413,177459,180757,571,3,2198,11.4,28934,4715,24219,2.6,16,35335,14572,20763,8.1,19.5,-6401,-3.5,32,0,1606,1607,10094
1986,50,g) 6 to 10,55508,62475,603452,609376,2032,3.1,6241,9.7,96596,16384,80212,2.7,15.9,107986,41739,66247,6.8,17.7,-11390,-1.8,31.8,0,4149,4161,22889
1986,50,l) Left Censored,133075,221310,4123337,4132536,9918,4.4,17760,7.9,563878,163010,400868,3.9,13.6,580447,197072,383375,4.8,14,-16569,-0.4,27.2,0,7107,7166,53327
1986,52,a) 0,130120,133116,946829,473415,132787,199.5,0,0,944467,944467,0,199.5,199.5,0,0,0,0,0,944467,199.5,0,0,,,
1986,52,b) 1,98379,101791,830250,851701,3926,3.4,28540,24.9,236171,59709,176462,7,27.7,273622,156476,117146,18.4,32.1,-37451,-4.4,55.4,0,21815,21884,123053
1986,52,c) 2,78101,81869,707776,744886,3593,4,19768,21.9,149629,30599,119030,4.1,20.1,221035,123063,97972,16.5,29.7,-71406,-9.6,40.2,0,15659,15663,97011
1986,52,d) 3,59417,63341,574894,606299,2955,4.3,13839,20.1,109758,24265,85493,4,18.1,170956,91503,79453,15.1,28.2,-61198,-10.1,36.2,0,10954,10966,70134
1986,52,e) 4,52696,59597,578208,602493,2410,3.8,11003,17.2,100443,22611,77832,3.8,16.7,147985,74576,73409,12.4,24.6,-47542,-7.9,33.4,0,8064,8137,52107
1986,52,f) 5,49388,55712,554623,573126,2452,4.1,9157,15.5,93379,24166,69213,4.2,16.3,130029,59518,70511,10.4,22.7,-36650,-6.4,32.6,0,6648,6702,40890
1986,52,g) 6 to 10,165456,207667,2160504,2202504,10095,4.7,28335,13.1,373339,109041,264298,5,17,456914,181595,275319,8.2,20.7,-83575,-3.7,34,0,18909,19029,110921
1986,52,l) Left Censored,305633,621633,11120171,11059865,35873,5.7,56173,8.9,1709472,655643,1053829,5.9,15.5,1585439,571315,1014124,5.2,14.3,124033,1.2,28.6,0,27103,27611,202158
1986,60,a) 0,40945,41116,174396,87198,40950,199.2,0,0,173860,173860,0,199.4,199.4,0,0,0,0,0,173860,199.4,0,0,,,
1986,60,b) 1,31693,32388,190541,187103,325,0.9,8526,23.2,66516,13219,53297,7.1,35.6,57277,30218,27059,16.2,30.6,9239,5,61.2,0,6025,6027,21684
1986,60,c) 2,25764,26188,166551,172711,918,3.2,5189,18.2,40411,4838,35573,2.8,23.4,51547,25873,25674,15,29.8,-11136,-6.4,46.8,0,3838,3838,18507
1986,60,d) 3,19432,19686,128244,130361,759,3.6,3452,16.3,28092,3342,24750,2.6,21.5,31892,17108,14784,13.1,24.5,-3800,-3,43,0,2575,2575,12592
1986,60,e) 4,16810,17022,134510,139121,623,3.5,2490,13.8,24233,2265,21968,1.6,17.4,33251,14839,18412,10.7,23.9,-9018,-6.5,34.8,0,1828,1828,11657
1986,60,f) 5,16152,16523,137513,137680,563,3.2,2180,12.6,27254,3714,23540,2.7,19.8,27429,13033,14396,9.5,19.9,-175,-0.1,39.6,0,1620,1621,10177
1986,60,g) 6 to 10,55606,58085,427187,431072,2469,4.1,6757,11.2,73284,11907,61377,2.8,17,80134,36410,43724,8.4,18.6,-6850,-1.6,34,0,4639,4650,19711
1986,60,l) Left Censored,132266,246624,4980616,4882820,12758,5.1,18033,7.2,785879,233428,552451,4.8,16.1,590701,199115,391586,4.1,12.1,195178,4,24.2,0,8348,8395,54908
1986,70,a) 0,184274,185839,1002093,501047,185327,199.4,0,0,999109,999109,0,199.4,199.4,0,0,0,0,0,999109,199.4,0,0,,,
1986,70,b) 1,146651,148981,1084002,1030040,2253,1.4,32620,19.7,365193,76635,288558,7.4,35.5,251235,133705,117530,13,24.4,113958,11.1,48.8,0,22349,22352,95777
1986,70,c) 2,141446,143889,1044610,1053423,5444,3.6,21303,14,238425,37705,200720,3.6,22.6,250742,122676,128066,11.6,23.8,-12317,-1.2,45.2,0,15128,15132,90859
1986,70,d) 3,97033,99805,822922,833789,4009,3.8,15183,14.4,168803,28085,140718,3.4,20.2,187761,91850,95911,11,22.5,-18958,-2.3,40.4,0,11019,11020,66541
1986,70,e) 4,89032,93031,854683,865425,3293,3.4,12199,12.5,151995,23474,128521,2.7,17.6,172609,74538,98071,8.6,19.9,-20614,-2.3,35.2,0,8574,8585,50437
1986,70,f) 5,82894,87493,897234,908169,3013,3.3,9882,10.9,147104,25565,121539,2.8,16.2,168106,65725,102381,7.2,18.5,-21002,-2.3,32.4,0,6777,6780,45515
1986,70,g) 6 to 10,261671,296050,3146696,3155635,11552,3.8,28803,9.4,523546,100202,423344,3.2,16.6,539869,192807,347062,6.1,17.1,-16323,-0.5,33.2,0,18405,18521,117465
1986,70,l) Left Censored,542492,654536,15128337,14978901,23195,3.5,47630,7.1,1997144,523129,1474015,3.5,13.3,1714278,479438,1234840,3.2,11.4,282866,1.9,22.8,0,27960,28086,189918
1987,07,a) 0,9794,9798,38251,19126,9739,198.8,0,0,38098,38098,0,199.2,199.2,0,0,0,0,0,38098,199.2,0,0,,,
1987,07,b) 1,6954,6955,35756,35981,4,0.1,1735,21.9,11974,102,11872,0.3,33.3,11716,6527,5189,18.1,32.6,258,0.7,65.2,0,1203,1203,4574
1987,07,c) 2,5639,5644,32491,33604,261,4.3,1064,17.4,9541,1197,8344,3.6,28.4,11365,5548,5817,16.5,33.8,-1824,-5.4,56.8,0,761,761,3428
1987,07,d) 3,4456,4472,28958,29036,194,4.1,625,13.3,7138,773,6365,2.7,24.6,7167,2864,4303,9.9,24.7,-29,-0.1,49.2,0,455,455,2024
1987,07,e) 4,3366,3372,22689,23024,141,4,450,12.7,5456,682,4774,3,23.7,6078,2761,3317,12,26.4,-622,-2.7,47.4,0,310,310,1956
1987,07,f) 5,3083,3089,22746,22896,121,3.8,364,11.3,4625,434,4191,1.9,20.2,4857,1969,2888,8.6,21.2,-232,-1,40.4,0,265,265,1212
1987,07,g) 6 to 10,12249,12301,92736,94421,510,4,1284,10.1,18143,2863,15280,3,19.2,21046,6947,14099,7.4,22.3,-2903,-3.1,38.4,0,882,882,5382
1987,07,l) Left Censored,13440,14571,162838,165924,576,3.8,1286,8.6,26075,4779,21296,2.9,15.7,31946,10189,21757,6.1,19.3,-5871,-3.6,31.4,0,839,844,4667
1987,10,a) 0,2236,2266,18561,9281,2252,198.8,0,0,18521,18521,0,199.6,199.6,0,0,0,0,0,18521,199.6,0,0,,,
1987,10,b) 1,1862,1870,17018,19799,23,1,834,36,4782,679,4103,3.4,24.2,9990,5717,4273,28.9,50.5,-5208,-26.3,48.4,0,691,691,4949
1987,10,c) 2,1804,1810,15120,18768,60,2.8,701,32.4,2864,420,2444,2.2,15.3,9882,5126,4756,27.3,52.7,-7018,-37.4,30.6,0,562,562,4012
1987,10,d) 3,1528,1544,14577,17677,61,3.4,523,29.3,3076,598,2478,3.4,17.4,9148,5582,3566,31.6,51.8,-6072,-34.4,34.8,0,427,427,4721
1987,10,e) 4,1331,1356,11349,13276,56,3.6,381,24.8,2267,447,1820,3.4,17.1,5888,2744,3144,20.7,44.4,-3621,-27.3,34.2,0,306,306,1839
1987,10,f) 5,1764,1814,15616,19785,64,3.1,565,27.1,2286,473,1813,2.4,11.6,10470,5100,5370,25.8,52.9,-8184,-41.3,23.2,0,423,428,3773
1987,10,g) 6 to 10,4986,5289,61480,71078,204,3.5,1175,20.2,9116,1949,7167,2.7,12.8,27781,9388,18393,13.2,39.1,-18665,-26.3,25.6,0,879,882,6690
1987,10,l) Left Censored,7235,12538,507441,551398,715,5.4,2092,15.8,65257,19415,45842,3.5,11.8,151063,54629,96434,9.9,27.4,-85806,-15.6,23.6,0,671,698,7259
1987,15,a) 0,74953,74977,352590,176295,74537,198.8,0,0,351221,351221,0,199.2,199.2,0,0,0,0,0,351221,199.2,0,0,,,
1987,15,b) 1,53074,53112,351995,354107,60,0.1,14542,23.7,134379,1741,132638,0.5,37.9,132461,58406,74055,16.5,37.4,1918,0.5,74.8,0,10640,10640,45980
1987,15,c) 2,42793,42849,319455,337470,2374,5.1,8736,18.8,95544,10544,85000,3.1,28.3,127777,62544,65233,18.5,37.9,-32233,-9.6,56.6,0,6539,6539,41058
1987,15,d) 3,34012,34074,289826,299305,1764,4.8,6055,16.6,81806,8916,72890,3,27.3,98808,37693,61115,12.6,33,-17002,-5.7,54.6,0,4498,4498,29892
1987,15,e) 4,21754,21814,189072,196444,1119,4.8,3534,15.3,47532,5943,41589,3,24.2,60988,22069,38919,11.2,31,-13456,-6.8,48.4,0,2682,2682,18160
1987,15,f) 5,18721,18792,185205,190535,840,4.2,2803,14.1,43202,3499,39703,1.8,22.7,52965,18366,34599,9.6,27.8,-9763,-5.1,45.4,0,2114,2115,14678
1987,15,g) 6 to 10,101148,101638,920713,950569,5692,5.4,13346,12.6,209372,21699,187673,2.3,22,263058,82545,180513,8.7,27.7,-53686,-5.7,44,0,9391,9396,58294
1987,15,l) Left Censored,125596,130927,2184744,2227886,4839,3.6,13602,10,418753,58776,359977,2.6,18.8,501664,145430,356234,6.5,22.5,-82911,-3.7,37.6,0,9246,9296,59535
1987,20,a) 0,29847,29930,287693,143847,29836,199.4,0,0,287273,287273,0,199.7,199.7,0,0,0,0,0,287273,199.7,0,0,,,
1987,20,b) 1,23172,23379,310447,303124,204,0.8,5369,20.5,99649,11463,88186,3.8,32.9,82800,48752,34048,16.1,27.3,16849,5.6,54.6,0,4211,4213,34716
1987,20,c) 2,20865,21046,350715,356673,878,3.9,3823,16.8,77951,13744,64207,3.9,21.9,86931,43691,43240,12.2,24.4,-8980,-2.5,43.8,0,3050,3052,32212
1987,20,d) 3,16905,17383,358766,364064,603,3.3,2667,14.4,63160,7138,56022,2,17.3,72970,32124,40846,8.8,20,-9810,-2.7,34.6,0,2175,2176,25231
1987,20,e) 4,12882,13241,246646,249962,439,3.1,1815,13,45268,6155,39113,2.5,18.1,50932,23424,27508,9.4,20.4,-5664,-2.3,36.2,0,1462,1463,17244
1987,20,f) 5,12900,13197,260625,264461,357,2.6,1542,11.2,41092,5378,35714,2,15.5,48095,18976,29119,7.2,18.2,-7003,-2.7,31,0,1230,1231,12744
1987,20,g) 6 to 10,55909,58517,1393378,1421533,1767,2.9,6144,10.1,204113,29872,174241,2.1,14.4,254338,85534,168804,6,17.9,-50225,-3.5,28.8,0,4498,4517,50090
1987,20,l) Left Censored,116878,169100,15361254,15681122,5052,2.9,14651,8.4,1372454,274622,1097832,1.8,8.8,1974233,666217,1308016,4.2,12.6,-601779,-3.8,17.6,0,6801,6922,109919
1987,40,a) 0,23485,24488,151948,75974,24401,199.3,0,0,151639,151639,0,199.6,199.6,0,0,0,0,0,151639,199.6,0,0,,,
1987,40,b) 1,16391,16647,132313,131276,181,1,4451,23.4,41847,4475,37372,3.4,31.9,37910,22532,15378,17.2,28.9,3937,3,57.8,0,3487,3492,17703
1987,40,c) 2,13125,13428,119684,123223,673,4.6,2897,19.8,30102,6058,24044,4.9,24.4,35371,19344,16027,15.7,28.7,-5269,-4.3,48.8,0,2353,2357,15900
1987,40,d) 3,10725,10963,99780,104383,502,4.2,2147,18.1,21555,3900,17655,3.7,20.6,30528,18050,12478,17.3,29.2,-8973,-8.6,41.2,0,1731,1731,14635
1987,40,e) 4,7811,10245,227929,239618,594,5.5,1717,15.8,31856,8358,23498,3.5,13.3,55349,26319,29030,11,23.1,-23493,-9.8,26.6,0,1201,1329,20730
1987,40,f) 5,7433,12066,350393,351072,1033,8.4,1555,12.6,67551,26891,40660,7.7,19.2,68290,16110,52180,4.6,19.5,-739,-0.3,38.4,0,1049,1052,9174
1987,40,g) 6 to 10,28713,32752,440117,451807,2202,6.5,4504,13.2,92256,33936,58320,7.5,20.4,113183,59393,53790,13.1,25.1,-20927,-4.7,40.8,0,3243,3250,32055
1987,40,l) Left Censored,45318,88622,3585791,3587820,6725,7.5,9241,10.3,580032,233853,346179,6.5,16.2,580682,201224,379458,5.6,16.2,-650,0,32.4,0,3533,3670,61302
1987,50,a) 0,36115,37094,179115,89558,36980,199.4,0,0,178816,178816,0,199.7,199.7,0,0,0,0,0,178816,199.7,0,0,,,
1987,50,b) 1,28210,29225,186905,184558,883,2.7,6343,19.6,56437,10969,45468,5.9,30.6,49847,25124,24723,13.6,27,6590,3.6,54,0,4852,4854,19374
1987,50,c) 2,24970,26029,186421,190189,1563,5.7,4367,15.8,45840,11765,34075,6.2,24.1,51963,24461,27502,12.9,27.3,-6123,-3.2,48.2,0,3446,3452,17575
1987,50,d) 3,20724,22635,181898,183823,1289,5.4,3176,13.4,41019,11405,29614,6.2,22.3,44176,18695,25481,10.2,24,-3157,-1.7,44.6,0,2483,2485,13463
1987,50,e) 4,16613,17987,147576,148957,1034,5.5,2464,13.1,32258,9819,22439,6.6,21.7,34490,14119,20371,9.5,23.2,-2232,-1.5,43.4,0,1897,1906,10111
1987,50,f) 5,16323,17572,162907,166737,698,3.8,2404,13,29459,4837,24622,2.9,17.7,36423,17005,19418,10.2,21.8,-6964,-4.1,35.4,0,1655,1669,9727
1987,50,g) 6 to 10,66816,75625,763500,774428,3281,4.2,8463,10.8,125853,25803,100050,3.3,16.3,144877,58355,86522,7.5,18.7,-19024,-2.4,32.6,0,5258,5349,33662
1987,50,l) Left Censored,124045,211255,4004262,4071018,11140,5.1,22131,10.2,577737,154921,422816,3.8,14.2,705765,287442,418323,7.1,17.3,-128028,-3.1,28.4,0,7477,7753,66359
1987,52,a) 0,133809,140367,973484,486742,139974,199.4,0,0,972178,972178,0,199.7,199.7,0,0,0,0,0,972178,199.7,0,0,,,
1987,52,b) 1,98238,104406,833961,894954,3157,2.7,29999,25.2,219131,42280,176851,4.7,24.5,331949,180312,151637,20.1,37.1,-112818,-12.6,49,0,24406,24434,144558
1987,52,c) 2,80144,85714,748904,793506,5731,6.1,20489,21.9,180696,51840,128856,6.5,22.8,263008,146220,116788,18.4,33.1,-82312,-10.3,45.6,0,16453,16496,104634
1987,52,d) 3,65740,71673,645468,677883,4726,6.1,14539,18.9,135105,46515,88590,6.9,19.9,196213,104371,91842,15.4,28.9,-61108,-9,39.8,0,11617,11635,77442
1987,52,e) 4,50896,56735,526234,554268,3585,5.9,10355,17.2,104255,34997,69258,6.3,18.8,157956,81400,76556,14.7,28.5,-53701,-9.7,37.6,0,8015,8056,54673
1987,52,f) 5,45900,53052,542546,560094,2777,4.9,9130,16.2,99568,27427,72141,4.9,17.8,133272,65446,67826,11.7,23.8,-33704,-6,35.6,0,6420,6551,44446
1987,52,g) 6 to 10,192232,242378,2605738,2663072,14736,5.8,35712,14.1,471788,148428,323360,5.6,17.7,576586,259568,317018,9.7,21.7,-104798,-4,35.4,0,21655,22343,149853
1987,52,l) Left Censored,279427,604612,11255700,11214751,44091,7.2,61264,10,1840264,732408,1107856,6.5,16.4,1746618,707634,1038984,6.3,15.6,93646,0.8,31.2,0,25537,26442,180117
1987,60,a) 0,43754,44179,196332,98166,43957,199,0,0,195726,195726,0,199.4,199.4,0,0,0,0,0,195726,199.4,0,0,,,
1987,60,b) 1,31594,31782,184137,178262,179,0.5,8409,23.1,68053,3558,64495,2,38.2,53154,32873,20281,18.4,29.8,14899,8.4,59.6,0,6484,6488,25007
1987,60,c) 2,26822,27501,173990,180627,1181,4,5466,18.3,42595,5530,37065,3.1,23.6,54376,29722,24654,16.5,30.1,-11781,-6.5,47.2,0,4309,4317,19267
1987,60,d) 3,22571,23055,161575,164625,979,4,3836,15.6,36997,5192,31805,3.2,22.5,42021,21317,20704,12.9,25.5,-5024,-3,45,0,3048,3054,17567
1987,60,e) 4,17244,17654,123297,124681,813,4.4,2660,14.3,27520,4692,22828,3.8,22.1,29663,13915,15748,11.2,23.8,-2143,-1.7,44.2,0,2064,2066,10020
1987,60,f) 5,15084,15451,134703,135314,651,4,2208,13.6,25133,4180,20953,3.1,18.6,26267,11772,14495,8.7,19.4,-1134,-0.8,37.2,0,1690,1692,8887
1987,60,g) 6 to 10,66164,69126,549972,554546,3141,4.4,8253,11.5,93032,14170,78862,2.6,16.8,99926,45562,54364,8.2,18,-6894,-1.2,33.6,0,6116,6134,32381
1987,60,l) Left Censored,123589,239238,5034553,5012939,14455,5.9,21644,8.9,725049,218229,506820,4.4,14.5,678253,225921,452332,4.5,13.5,46796,1,27,0,8669,8826,54233
1987,70,a) 0,190659,195409,1386835,693418,193143,197.7,0,0,1085934,1085934,0,156.6,156.6,0,0,0,0,0,1085934,156.6,0,0,,,
1987,70,b) 1,145766,150344,1559550,1546486,2854,1.7,34243,20.4,332688,43886,288802,2.8,21.5,296518,155227,141291,10,19.2,36170,2.3,38.4,0,25484,25504,117012
1987,70,c) 2,126582,131102,1058439,1070860,7481,5.3,22671,16.2,259222,59186,200036,5.5,24.2,277748,133886,143862,12.5,25.9,-18526,-1.7,48.4,0,17041,17077,98172
1987,70,d) 3,127851,132506,1032296,1040496,6069,4.4,16437,11.9,232109,52692,179417,5.1,22.3,244530,110015,134515,10.6,23.5,-12421,-1.2,44.6,0,12201,12205,83263
1987,70,e) 4,87600,92686,833335,834270,4983,5.2,11869,12.3,189440,54029,135411,6.5,22.7,189277,77478,111799,9.3,22.7,163,0,45.4,0,8800,8816,55069
1987,70,f) 5,81030,85552,832041,840081,3440,3.9,10522,11.8,145692,22634,123058,2.7,17.3,162718,68499,94219,8.2,19.4,-17026,-2.1,34.6,0,7486,7560,47834
1987,70,g) 6 to 10,320861,362186,4073568,4094269,16754,4.5,37765,10.1,710672,132263,578409,3.2,17.4,739784,290957,448827,7.1,18.1,-29112,-0.7,34.8,0,23213,23546,172379
1987,70,l) Left Censored,513081,629429,14804931,14931862,25596,4,50982,7.9,1828577,414072,1414505,2.8,12.2,2029121,703781,1325340,4.7,13.6,-200544,-1.4,24.4,0,28045,28397,259877
1988,07,a) 0,9333,9341,37620,18810,9228,197.6,0,0,37281,37281,0,198.2,198.2,0,0,0,0,0,37281,198.2,0,0,,,
1988,07,b) 1,7270,7276,38048,38188,8,0.1,2232,26.1,13599,249,13350,0.7,35.6,12272,6759,5513,17.7,32.1,1327,3.5,64.2,0,1585,1585,5041
1988,07,c) 2,5801,5803,32638,33816,191,3,1193,18.8,8672,810,7862,2.4,25.6,10682,4789,5893,14.2,31.6,-2010,-6,51.2,0,872,872,3765
1988,07,d) 3,4959,4966,28896,30551,167,3.2,793,15,6835,670,6165,2.2,22.4,9754,4639,5115,15.2,31.9,-2919,-9.5,44.8,0,564,564,3795
1988,07,e) 4,3988,3991,28085,28468,119,2.8,549,13,6285,711,5574,2.5,22.1,6963,2842,4121,10,24.5,-678,-2.4,44.2,0,378,378,1967
1988,07,f) 5,3096,3102,23130,22882,106,3.3,369,11.4,5254,417,4837,1.8,23,4716,1684,3032,7.4,20.6,538,2.4,41.2,0,264,264,1357
1988,07,g) 6 to 10,12311,12338,95876,96254,390,3.1,1223,9.6,18292,2061,16231,2.1,19,19012,6040,12972,6.3,19.8,-720,-0.8,38,0,837,837,4322
1988,07,h) 11 to 15,2028,2052,18563,18507,78,3.7,165,7.9,3208,411,2797,2.2,17.3,3066,828,2238,4.5,16.6,142,0.7,33.2,0,105,105,556
1988,07,l) Left Censored,12730,13763,164005,163223,459,3.2,1250,8.8,31392,7589,23803,4.6,19.2,28793,10126,18667,6.2,17.6,2599,1.6,35.2,0,706,706,4306
1988,10,a) 0,2278,2284,17916,8958,2260,197.9,0,0,17683,17683,0,197.4,197.4,0,0,0,0,0,17683,197.4,0,0,,,
1988,10,b) 1,1662,1694,19169,18748,26,1.3,544,27.5,6927,1038,5889,5.5,36.9,5987,3510,2477,18.7,31.9,940,5,63.8,0,459,459,3011
1988,10,c) 2,1532,1540,15534,16333,73,4.3,394,23.1,3526,655,2871,4,21.6,5059,3245,1814,19.9,31,-1533,-9.4,43.2,0,331,331,2452
1988,10,d) 3,1527,1537,15972,15356,77,4.6,346,20.7,4866,1750,3116,11.4,31.7,3628,2016,1612,13.1,23.6,1238,8.1,47.2,0,280,280,1589
1988,10,e) 4,1286,1302,14834,14694,61,4.3,293,20.6,3541,405,3136,2.8,24.1,3264,1391,1873,9.5,22.2,277,1.9,44.4,0,230,230,1016
1988,10,f) 5,1163,1188,10270,10840,52,4.1,207,16.3,2035,259,1776,2.4,18.8,3146,1095,2051,10.1,29,-1111,-10.2,37.6,0,168,168,648
1988,10,g) 6 to 10,5331,5520,65079,64954,270,4.6,981,16.7,15881,4166,11715,6.4,24.4,15531,7677,7854,11.8,23.9,350,0.5,47.8,0,658,658,4611
1988,10,h) 11 to 15,691,781,11314,11358,30,3.7,114,13.9,2458,320,2138,2.8,21.6,2484,1167,1317,10.3,21.9,-26,-0.3,43.2,0,59,59,379
1988,10,l) Left Censored,6754,11786,481064,494647,672,5.5,1405,11.6,72884,16565,56319,3.3,14.7,99621,35550,64071,7.2,20.1,-26737,-5.4,29.4,0,418,418,2581
1988,15,a) 0,68343,68378,335458,167729,67577,197.7,0,0,332186,332186,0,198,198,0,0,0,0,0,332186,198,0,0,,,
1988,15,b) 1,53836,53858,342539,347170,41,0.1,18900,29.3,123630,2159,121471,0.6,35.6,126491,71572,54919,20.6,36.4,-2861,-0.8,71.2,0,14543,14543,57701
1988,15,c) 2,43686,43718,318830,335101,1750,3.6,10390,21.5,90267,7989,82278,2.4,26.9,120136,55671,64465,16.6,35.9,-29869,-9,53.8,0,7960,7960,45471
1988,15,d) 3,37008,37067,292578,305881,1567,3.9,7032,17.6,74256,7756,66500,2.5,24.3,99682,39712,59970,13,32.6,-25426,-8.3,48.6,0,5446,5446,32314
1988,15,e) 4,29795,29850,266789,278288,1223,3.8,5217,16.3,61425,5494,55931,2,22.1,83679,29366,54313,10.6,30.1,-22254,-8,44.2,0,3907,3907,24063
1988,15,f) 5,19316,19371,177188,183150,779,3.8,3127,15.2,39691,3895,35796,2.1,21.7,51049,17767,33282,9.7,27.9,-11358,-6.2,43.4,0,2381,2381,14022
1988,15,g) 6 to 10,92772,93198,895307,917294,4130,4.2,12156,12.5,187044,18888,168156,2.1,20.4,231134,68536,162598,7.5,25.2,-44090,-4.8,40.8,0,8665,8665,50355
1988,15,h) 11 to 15,17279,17426,161855,166074,813,4.5,2149,11.9,32124,3866,28258,2.3,19.3,41512,11900,29612,7.2,25,-9388,-5.7,38.6,0,1437,1437,8632
1988,15,l) Left Censored,117033,122261,2096266,2136020,3827,3,11813,9.3,374306,46252,328054,2.2,17.5,453285,100036,353249,4.7,21.2,-78979,-3.7,35,0,8009,8009,43108
1988,20,a) 0,28455,28556,326859,163430,28267,198,0,0,323099,323099,0,197.7,197.7,0,0,0,0,0,323099,197.7,0,0,,,
1988,20,b) 1,23303,23400,332006,308793,338,1.3,6207,23.3,127454,32954,94500,10.7,41.3,78131,49955,28176,16.2,25.3,49323,16,50.6,0,5146,5146,40684
1988,20,c) 2,19833,20109,315577,314120,710,3.3,3803,17.5,78806,16150,62656,5.1,25.1,74136,38686,35450,12.3,23.6,4670,1.5,47.2,0,3111,3111,30807
1988,20,d) 3,18574,18790,354511,351784,629,3.2,2860,14.4,71717,15840,55877,4.5,20.4,67263,30806,36457,8.8,19.1,4454,1.3,38.2,0,2378,2378,24487
1988,20,e) 4,15225,15626,347240,349965,444,2.7,2157,13.1,60045,7088,52957,2,17.2,64825,33016,31809,9.4,18.5,-4780,-1.3,34.4,0,1693,1693,19526
1988,20,f) 5,11732,12149,251174,249530,326,2.6,1417,11.2,44888,7697,37191,3.1,18,41282,16398,24884,6.6,16.5,3606,1.5,33,0,1163,1163,11789
1988,20,g) 6 to 10,54707,56938,1393152,1379293,1627,2.8,5157,8.8,228039,42704,185335,3.1,16.5,201497,62532,138965,4.5,14.6,26542,1.9,29.2,0,3855,3855,39122
1988,20,h) 11 to 15,9963,10992,346134,338233,375,3.3,841,7.5,55748,13409,42339,4,16.5,42892,14727,28165,4.4,12.7,12856,3.8,25.4,0,528,528,5333
1988,20,l) Left Censored,111591,163263,15380465,15352961,5631,3.4,11095,6.7,1706058,391324,1314734,2.5,11.1,1601203,533757,1067446,3.5,10.4,104855,0.7,20.8,0,4990,4990,62802
1988,40,a) 0,20229,20601,122194,61097,20403,198.1,0,0,121260,121260,0,198.5,198.5,0,0,0,0,0,121260,198.5,0,0,,,
1988,40,b) 1,17369,18403,154829,152886,183,0.9,5707,26.6,49927,7224,42703,4.7,32.7,44509,27063,17446,17.7,29.1,5418,3.6,58.2,0,4649,4649,22769
1988,40,c) 2,13337,13596,123564,127702,454,3,3274,21.7,29552,4637,24915,3.6,23.1,37709,22327,15382,17.5,29.5,-8157,-6.4,46.2,0,2685,2685,19179
1988,40,d) 3,11153,11343,113123,113044,391,3.2,2238,18.2,26183,3322,22861,2.9,23.2,26618,13808,12810,12.2,23.5,-435,-0.3,46.4,0,1829,1829,10970
1988,40,e) 4,9318,9572,94424,96613,328,3.2,1634,16,18355,2431,15924,2.5,19,22849,12113,10736,12.5,23.7,-4494,-4.7,38,0,1340,1340,9209
1988,40,f) 5,6866,9461,228544,227732,479,4.9,1167,11.9,31788,7412,24376,3.3,14,29254,10109,19145,4.4,12.8,2534,1.2,25.6,0,843,843,5127
1988,40,g) 6 to 10,27882,33865,643073,646292,1420,4,4507,12.7,95558,21039,74519,3.3,14.8,101728,36457,65271,5.6,15.7,-6170,-0.9,29.6,0,2828,2828,23510
1988,40,h) 11 to 15,4673,7547,170054,154439,937,12.6,732,9.8,53517,31218,22299,20.2,34.7,20516,7984,12532,5.2,13.3,33001,21.4,26.6,0,382,382,2251
1988,40,l) Left Censored,40516,83213,3609147,3569331,5031,5.9,7942,9.4,484350,125715,358635,3.5,13.6,394838,131791,263047,3.7,11.1,89512,2.5,22.2,0,2581,2584,26530
1988,50,a) 0,32695,33030,159138,79569,32731,198.2,0,0,157866,157866,0,198.4,198.4,0,0,0,0,0,157866,198.4,0,0,,,
1988,50,b) 1,28307,29325,184578,181540,305,0.9,7335,22.1,57103,6665,50438,3.7,31.5,48857,28144,20713,15.5,26.9,8246,4.6,53.8,0,5902,5902,22802
1988,50,c) 2,24216,25319,170212,178919,884,3.2,4604,16.9,38988,5723,33265,3.2,21.8,55862,33900,21962,18.9,31.2,-16874,-9.4,43.6,0,3738,3738,30028
1988,50,d) 3,22189,23403,189588,187824,790,3.2,3364,13.6,40631,7007,33624,3.7,21.6,37270,17068,20202,9.1,19.8,3361,1.8,39.6,0,2692,2692,13517
1988,50,e) 4,18711,20708,182153,181795,677,3.1,2574,11.9,35943,5132,30811,2.8,19.8,35106,14049,21057,7.7,19.3,837,0.5,38.6,0,1977,1977,9651
1988,50,f) 5,15167,16685,148356,147806,594,3.4,1875,10.8,27907,4783,23124,3.2,18.9,26630,10997,15633,7.4,18,1277,0.9,36,0,1433,1433,8392
1988,50,g) 6 to 10,64969,71207,721492,719713,2309,3.1,6645,9.1,115274,19889,95385,2.8,16,112258,41813,70445,5.8,15.6,3016,0.4,31.2,0,4691,4691,26754
1988,50,h) 11 to 15,12769,17114,210054,210414,677,3.9,1345,7.7,32077,6199,25878,2.9,15.2,32871,10531,22340,5,15.6,-794,-0.4,30.4,0,669,669,4026
1988,50,l) Left Censored,117791,204495,3996098,3999326,9858,4.7,16154,7.8,606382,162542,443840,4.1,15.2,604388,217960,386428,5.4,15.1,1994,0.1,30.2,0,5460,5462,38724
1988,52,a) 0,118622,122263,845597,422799,121232,198.3,0,0,839346,839346,0,198.5,198.5,0,0,0,0,0,839346,198.5,0,0,,,
1988,52,b) 1,98108,104494,858437,914321,1237,1,34629,28.3,209007,22815,186192,2.5,22.9,312125,180775,131350,19.8,34.1,-103118,-11.2,45.8,0,28679,28679,151181
1988,52,c) 2,80035,86561,744054,788364,3484,3.7,20626,21.6,145297,29152,116145,3.7,18.4,232081,125470,106611,15.9,29.4,-86784,-11,36.8,0,17133,17133,100762
1988,52,d) 3,67621,73457,660918,706928,2964,3.7,14987,18.8,120044,24800,95244,3.5,17,212528,117941,94587,16.7,30.1,-92484,-13.1,34,0,12220,12220,97232
1988,52,e) 4,56848,63340,602061,623678,2719,4,11056,16.4,107197,26544,80653,4.3,17.2,150528,69790,80738,11.2,24.1,-43331,-6.9,34.4,0,8864,8864,53424
1988,52,f) 5,44822,50986,502725,514352,2155,4,7761,14.4,94388,23414,70974,4.6,18.4,117629,50624,67005,9.8,22.9,-23241,-4.5,36.8,0,6096,6096,37728
1988,52,g) 6 to 10,179764,214939,2280176,2338147,9107,4.1,27658,12.3,357828,94170,263658,4,15.3,474374,192158,282216,8.2,20.3,-116546,-5,30.6,0,19080,19080,117400
1988,52,h) 11 to 15,36322,59592,750079,757090,3473,5.7,6397,10.5,131756,44065,87691,5.8,17.4,146448,51598,94850,6.8,19.3,-14692,-1.9,34.8,0,2970,2971,16590
1988,52,l) Left Censored,258555,588602,11287268,11263112,41530,7,55547,9.3,1861505,707949,1153556,6.3,16.5,1782431,678175,1104256,6,15.8,79074,0.7,31.6,0,20133,20136,117986
1988,60,a) 0,37637,37860,188150,94075,37471,197.9,0,0,186158,186158,0,197.9,197.9,0,0,0,0,0,186158,197.9,0,0,,,
1988,60,b) 1,32433,32903,186958,190731,360,0.9,10526,27.3,59415,15105,44310,7.9,31.2,64080,38512,25568,20.2,33.6,-4665,-2.4,62.4,0,8338,8338,30879
1988,60,c) 2,26159,26361,158648,165018,874,3,5817,20,37794,5464,32330,3.3,22.9,48755,25577,23178,15.5,29.5,-10961,-6.6,45.8,0,4642,4642,21253
1988,60,d) 3,23258,23988,170318,172178,882,3.4,4205,16.4,38900,12529,26371,7.3,22.6,42338,20018,22320,11.6,24.6,-3438,-2,45.2,0,3332,3332,16819
1988,60,e) 4,19916,20347,143285,163309,653,3,3184,14.7,24537,3552,20985,2.2,15,64248,18206,46042,11.1,39.3,-39711,-24.3,30,0,2451,2451,14347
1988,60,f) 5,15552,15924,115483,119137,561,3.3,2289,13.6,20025,3387,16638,2.8,16.8,27345,12401,14944,10.4,23,-7320,-6.2,33.6,0,1672,1672,9427
1988,60,g) 6 to 10,63770,65449,509605,525378,2341,3.4,7184,10.6,79352,17370,61982,3.3,15.1,110209,50124,60085,9.5,21,-30857,-5.9,30.2,0,5134,5134,35588
1988,60,h) 11 to 15,11530,13577,141117,139540,802,5.8,1219,8.8,24048,6447,17601,4.6,17.2,21593,6533,15060,4.7,15.5,2455,1.7,31,0,744,744,3424
1988,60,l) Left Censored,116453,246500,5004941,4994988,26202,10.8,17628,7.3,797086,308117,488969,6.2,16,776435,236940,539495,4.7,15.5,20651,0.5,31,0,5810,5810,39924
1988,70,a) 0,171992,174247,1051711,525856,172589,198.1,0,0,1040878,1040878,0,197.9,197.9,0,0,0,0,0,1040878,197.9,0,0,,,
1988,70,b) 1,144114,149289,1954801,1954450,1196,0.7,42994,24.9,384919,37330,347589,1.9,19.7,369614,231119,138495,11.8,18.9,15305,0.8,37.8,0,33246,33249,150175
1988,70,c) 2,123513,128674,1040750,1044507,4978,3.6,24907,17.9,252420,36870,215550,3.5,24.2,256691,127016,129675,12.2,24.6,-4271,-0.4,48.4,0,19493,19493,101117
1988,70,d) 3,111899,116943,1019066,1029967,4274,3.4,17794,14.4,208557,31988,176569,3.1,20.2,231550,103831,127719,10.1,22.5,-22993,-2.3,40.4,0,13643,13643,78326
1988,70,e) 4,116572,121505,993283,1010403,3847,3,14256,11.2,187060,29269,157791,2.9,18.5,219603,93531,126072,9.3,21.7,-32543,-3.2,37,0,10285,10285,67663
1988,70,f) 5,79471,84988,796071,800372,2947,3.3,10297,11.6,153630,23599,130031,2.9,19.2,163624,63471,100153,7.9,20.4,-9994,-1.2,38.4,0,7347,7347,43425
1988,70,g) 6 to 10,316106,341278,3485230,3507436,12343,3.5,34127,9.7,594658,115632,479026,3.3,17,632466,229446,403020,6.5,18,-37808,-1,34,0,22995,22996,140591
1988,70,h) 11 to 15,57198,80498,1324922,1297866,3963,4.9,6275,7.7,251400,52273,199127,4,19.4,198625,58783,139842,4.5,15.3,52775,4.1,30.6,0,3093,3095,16508
1988,70,l) Left Censored,481826,602502,14326663,14210082,24134,3.9,43543,7.1,2044197,509908,1534289,3.6,14.4,1789328,564801,1224527,4,12.6,254869,1.8,25.2,0,23906,23910,139443
1989,07,a) 0,9470,9472,43397,21699,9405,198.6,0,0,43241,43241,0,199.3,199.3,0,0,0,0,0,43241,199.3,0,0,,,
1989,07,b) 1,7244,7254,40255,39026,6,0.1,1992,24,15262,115,15147,0.3,39.1,12531,6536,5995,16.7,32.1,2731,7,64.2,0,1260,1260,4125
1989,07,c) 2,6155,6161,38721,38394,227,3.4,1322,19.7,13181,952,12229,2.5,34.3,12419,5838,6581,15.2,32.3,762,2,64.6,0,877,877,4015
1989,07,d) 3,5098,5099,33456,32924,170,3.1,886,16.2,10388,1857,8531,5.6,31.6,9326,3662,5664,11.1,28.3,1062,3.3,56.6,0,587,587,2306
1989,07,e) 4,4481,4489,28070,28513,154,3.3,650,13.7,6492,530,5962,1.9,22.8,7502,3080,4422,10.8,26.3,-1010,-3.5,45.6,0,414,414,1753
1989,07,f) 5,3620,3622,27741,27931,119,3.1,503,13.2,5734,390,5344,1.4,20.5,6114,2407,3707,8.6,21.9,-380,-1.4,41,0,322,322,1417
1989,07,g) 6 to 10,12325,12360,99998,101398,414,3.2,1468,11.4,18315,1700,16615,1.7,18.1,21179,7809,13370,7.7,20.9,-2864,-2.8,36.2,0,827,827,4466
1989,07,h) 11 to 15,3801,3839,33696,34618,114,2.9,416,10.4,5538,501,5037,1.4,16,7390,2216,5174,6.4,21.3,-1852,-5.3,32,0,216,216,1258
1989,07,l) Left Censored,11935,13024,163510,163279,484,3.6,1142,8.6,29109,4187,24922,2.6,17.8,29502,9205,20297,5.6,18.1,-393,-0.3,35.6,0,628,636,4077
1989,10,a) 0,1988,1996,18138,9069,1983,198.7,0,0,18052,18052,0,199.1,199.1,0,0,0,0,0,18052,199.1,0,0,,,
1989,10,b) 1,1663,1667,16795,17310,5,0.3,595,30.1,5305,269,5036,1.6,30.6,6281,4187,2094,24.2,36.3,-976,-5.7,61.2,0,462,462,3645
1989,10,c) 2,1327,1370,16197,17595,48,3.1,357,23.3,3609,298,3311,1.7,20.5,6283,3190,3093,18.1,35.7,-2674,-15.2,41,0,293,293,2541
1989,10,d) 3,1292,1299,12809,14180,53,3.7,294,20.7,2260,199,2061,1.4,15.9,5038,3267,1771,23,35.5,-2778,-19.6,31.8,0,228,228,2670
1989,10,e) 4,1295,1312,13137,14628,49,3.4,272,19.1,2306,532,1774,3.6,15.8,5316,1846,3470,12.6,36.3,-3010,-20.5,31.6,0,222,222,1396
1989,10,f) 5,1109,1127,14661,14726,40,3.3,212,17.5,3788,238,3550,1.6,25.7,3918,1690,2228,11.5,26.6,-130,-0.9,51.4,0,171,171,1016
1989,10,g) 6 to 10,5132,5339,59353,62800,212,3.7,876,15.5,10993,2404,8589,3.8,17.5,17824,7609,10215,12.1,28.4,-6831,-10.9,35,0,630,630,4455
1989,10,h) 11 to 15,1303,1409,17951,19144,60,4.1,175,11.9,2341,412,1929,2.2,12.2,4707,1682,3025,8.8,24.6,-2366,-12.4,24.4,0,112,112,926
1989,10,l) Left Censored,6298,11371,465212,472858,659,5.7,1091,9.4,67813,23512,44301,5,14.3,83756,31017,52739,6.6,17.7,-15943,-3.4,28.6,0,399,408,4694
1989,15,a) 0,65026,65041,310917,155459,64468,198.2,0,0,308891,308891,0,198.7,198.7,0,0,0,0,0,308891,198.7,0,0,,,
1989,15,b) 1,50935,50985,345861,340391,33,0.1,16397,27.5,126884,1059,125825,0.3,37.3,112788,63140,49648,18.5,33.1,14096,4.2,66.2,0,11325,11325,47466
1989,15,c) 2,44283,44306,312542,327218,1835,3.7,11116,22.6,91862,7825,84037,2.4,28.1,119833,57767,62066,17.7,36.6,-27971,-8.5,56.2,0,7996,7996,44639
1989,15,d) 3,37503,37539,293139,305972,1619,4,7815,19.2,73781,7295,66486,2.4,24.1,99555,43130,56425,14.1,32.5,-25774,-8.4,48.2,0,5602,5605,32559
1989,15,e) 4,32273,32352,271960,282881,1250,3.6,5977,17.2,65141,4899,60242,1.7,23,86819,32817,54002,11.6,30.7,-21678,-7.7,46,0,4147,4147,24757
1989,15,f) 5,26383,26440,248656,256041,1086,3.9,4503,16,57122,5369,51753,2.1,22.3,71854,26812,45042,10.5,28.1,-14732,-5.8,44.6,0,2978,2979,19100
1989,15,g) 6 to 10,84545,85086,865090,883771,3440,3.8,12130,13.6,184068,17107,166961,1.9,20.8,220761,72095,148666,8.2,25,-36693,-4.2,41.6,0,7486,7493,45761
1989,15,h) 11 to 15,33254,33455,314316,324202,1593,4.6,4568,13.1,59971,6636,53335,2,18.5,79780,23493,56287,7.2,24.6,-19809,-6.1,37,0,2708,2710,14417
1989,15,l) Left Censored,108339,113364,2013918,2055611,3478,3,12081,10.3,354620,46108,308512,2.2,17.3,437986,110852,327134,5.4,21.3,-83366,-4,34.6,0,7514,7526,43672
1989,20,a) 0,27751,27818,279277,139639,27635,198.7,0,0,277829,277829,0,199,199,0,0,0,0,0,277829,199,0,0,,,
1989,20,b) 1,22692,22932,343317,337704,242,0.9,5660,22,117171,21679,95492,6.4,34.7,110854,62481,48373,18.5,32.8,6317,1.9,65.6,0,4351,4356,50677
1989,20,c) 2,19528,19645,285580,305902,556,2.6,4207,19.6,66214,6975,59239,2.3,21.6,104499,71485,33014,23.4,34.2,-38285,-12.6,43.2,0,3379,3380,63469
1989,20,d) 3,17367,17672,326891,320841,519,2.7,2977,15.8,74223,6858,67365,2.1,23.1,63067,31463,31604,9.8,19.7,11156,3.4,39.4,0,2313,2314,23914
1989,20,e) 4,16567,16842,361564,363313,433,2.4,2464,13.8,56739,5837,50902,1.6,15.6,62281,27686,34595,7.6,17.1,-5542,-1.5,31.2,0,1879,1881,20078
1989,20,f) 5,13634,14043,336867,336763,389,2.6,1973,13.3,56426,10615,45811,3.2,16.8,56600,26739,29861,7.9,16.8,-174,0,33.6,0,1441,1447,18560
1989,20,g) 6 to 10,52017,54671,1471704,1456127,1458,2.6,6057,10.6,240369,36370,203999,2.5,16.5,219041,88105,130936,6.1,15,21328,1.5,30,0,4020,4029,49420
1989,20,h) 11 to 15,18432,19971,596133,594753,662,3.2,1820,8.9,84809,14432,70377,2.4,14.3,82670,31975,50695,5.4,13.9,2139,0.4,27.8,0,1099,1123,14654
1989,20,l) Left Censored,105274,157997,15398375,15367502,5437,3.4,11195,7,1579530,385749,1193781,2.5,10.3,1537032,440256,1096776,2.9,10,42498,0.3,20,0,5357,5515,100388
1989,40,a) 0,20109,20319,120503,60252,20191,198.7,0,0,119997,119997,0,199.2,199.2,0,0,0,0,0,119997,199.2,0,0,,,
1989,40,b) 1,15587,15956,130132,125410,123,0.7,4494,24.6,43302,3030,40272,2.4,34.5,33669,20225,13444,16.1,26.8,9633,7.7,53.6,0,3337,3337,15651
1989,40,c) 2,14379,15357,144914,148953,565,3.3,3521,20.9,35011,4159,30852,2.8,23.5,42300,24246,18054,16.3,28.4,-7289,-4.9,47,0,2651,2662,18848
1989,40,d) 3,11439,11716,139241,131461,386,3,2314,18.3,44898,2557,42341,1.9,34.2,29408,15055,14353,11.5,22.4,15490,11.8,44.8,0,1805,1806,11250
1989,40,e) 4,9681,9931,112497,114390,334,3.1,1796,16.9,23541,3396,20145,3,20.6,27412,15925,11487,13.9,24,-3871,-3.4,41.2,0,1388,1388,12997
1989,40,f) 5,8191,8466,90861,92203,285,3.2,1390,15.4,17345,2311,15034,2.5,18.8,20140,10540,9600,11.4,21.8,-2795,-3,37.6,0,1059,1059,7892
1989,40,g) 6 to 10,27209,36481,796838,798939,2434,6.5,4274,11.4,114521,24230,90291,3,14.3,118099,46537,71562,5.8,14.8,-3578,-0.5,28.6,0,2704,2712,27378
1989,40,h) 11 to 15,8545,11805,236496,232174,643,5.3,1231,10.2,45563,8279,37284,3.6,19.6,36496,12069,24427,5.2,15.7,9067,3.9,31.4,0,696,697,5016
1989,40,l) Left Censored,37477,82425,3642772,3632063,5526,6.7,6964,8.4,513108,162960,350148,4.5,14.1,506391,156921,349470,4.3,13.9,6717,0.2,27.8,0,2526,2714,29132
1989,50,a) 0,32753,33087,166441,83221,32907,198.9,0,0,165842,165842,0,199.3,199.3,0,0,0,0,0,165842,199.3,0,0,,,
1989,50,b) 1,26358,27015,174201,169841,265,0.9,6186,20.5,56633,8434,48199,5,33.3,47467,28584,18883,16.8,27.9,9166,5.4,55.8,0,4571,4577,22788
1989,50,c) 2,24227,25283,176050,179657,804,2.9,4733,17.3,39527,4266,35261,2.4,22,45472,25635,19837,14.3,25.3,-5945,-3.3,44,0,3585,3593,18665
1989,50,d) 3,21510,22753,170797,170455,789,3.3,3381,14.1,35000,4103,30897,2.4,20.5,34566,16958,17608,9.9,20.3,434,0.2,40.6,0,2578,2586,12900
1989,50,e) 4,19974,21289,188038,189414,711,3.2,2871,12.8,33962,5089,28873,2.7,17.9,37138,17855,19283,9.4,19.6,-3176,-1.7,35.8,0,2072,2091,11369
1989,50,f) 5,16937,19010,182579,181903,595,3,2300,11.6,32986,5139,27847,2.8,18.1,31938,14922,17016,8.2,17.6,1048,0.5,35.2,0,1659,1659,9501
1989,50,g) 6 to 10,63880,71213,734167,737025,2559,3.5,7172,9.8,115998,20966,95032,2.8,15.7,122177,48368,73809,6.6,16.6,-6179,-0.9,31.4,0,4571,4593,29486
1989,50,h) 11 to 15,22273,27968,341999,341683,924,3.2,2392,8.3,52297,8692,43605,2.5,15.3,51637,18538,33099,5.4,15.1,660,0.2,30.2,0,1324,1347,9248
1989,50,l) Left Censored,111002,199195,4013834,4000879,9843,4.9,15336,7.6,568887,162553,406334,4.1,14.2,556061,214588,341473,5.4,13.9,12826,0.3,27.8,0,5460,5619,51140
1989,52,a) 0,114411,117931,859434,429717,117225,198.8,0,0,856556,856556,0,199.3,199.3,0,0,0,0,0,856556,199.3,0,0,,,
1989,52,b) 1,90012,94373,793725,827078,1155,1.1,28451,26.2,206578,22909,183669,2.8,25,270256,158892,111364,19.2,32.7,-63678,-7.7,50,0,22330,22363,129883
1989,52,c) 2,79801,86346,767953,812066,3327,3.5,21384,22.4,154727,31804,122923,3.9,19.1,242383,138418,103965,17,29.8,-87656,-10.7,38.2,0,16686,16764,107375
1989,52,d) 3,67665,74171,678879,710336,2803,3.5,15356,19.1,120165,23710,96455,3.3,16.9,185617,99375,86242,14,26.1,-65452,-9.2,33.8,0,11709,11753,73842
1989,52,e) 4,58509,65293,620110,641217,2665,3.8,11534,16.6,106459,24266,82193,3.8,16.6,150555,75839,74716,11.8,23.5,-44096,-6.9,33.2,0,8742,8773,55335
1989,52,f) 5,49643,56210,570123,585167,2260,3.8,9376,15.7,97656,27002,70654,4.6,16.7,128919,63064,65855,10.8,22,-31263,-5.3,33.4,0,6828,6893,45292
1989,52,g) 6 to 10,172810,208502,2284368,2334173,7979,3.7,28924,13.2,361703,84710,276993,3.6,15.5,470117,210937,259180,9,20.1,-108414,-4.6,31,0,18612,18971,127293
1989,52,h) 11 to 15,61604,92354,1141977,1151017,4726,5,9741,10.3,179522,54779,124743,4.8,15.6,198132,75536,122596,6.6,17.2,-18610,-1.6,31.2,0,5345,5561,36704
1989,52,l) Left Censored,236999,579140,11542347,11401577,38382,6.6,48349,8.3,1825099,757811,1067288,6.6,16,1617896,508864,1109032,4.5,14.2,207203,1.8,28.4,0,19396,20633,149914
1989,60,a) 0,36592,36988,175090,87545,36748,198.7,0,0,174068,174068,0,198.8,198.8,0,0,0,0,0,174068,198.8,0,0,,,
1989,60,b) 1,29106,29487,175305,181598,234,0.7,8102,24.1,55148,5907,49241,3.3,30.4,66792,41459,25333,22.8,36.8,-11644,-6.4,60.8,0,6030,6030,33487
1989,60,c) 2,27153,27634,169495,178245,1008,3.3,5991,19.8,39575,5486,34089,3.1,22.2,55528,32687,22841,18.3,31.2,-15953,-9,44.4,0,4528,4528,26463
1989,60,d) 3,22645,22862,144452,151241,809,3.3,4239,17.2,28046,3555,24491,2.4,18.5,40810,20258,20552,13.4,27,-12764,-8.5,37,0,3224,3251,16050
1989,60,e) 4,20570,21361,161783,165471,724,3.2,3337,14.7,28575,3556,25019,2.1,17.3,36864,18171,18693,11,22.3,-8289,-5,34.6,0,2483,2483,14043
1989,60,f) 5,17996,18422,131160,135143,623,3.2,2551,13.2,23233,5064,18169,3.7,17.2,29343,13581,15762,10,21.7,-6110,-4.5,34.4,0,1870,1870,9905
1989,60,g) 6 to 10,61886,63673,504790,517255,2385,3.6,7860,11.8,78476,14142,64334,2.7,15.2,103372,49420,53952,9.6,20,-24896,-4.8,30.4,0,5207,5211,30435
1989,60,h) 11 to 15,21819,24114,221415,225360,987,3.9,2861,11.4,31368,6057,25311,2.7,13.9,39421,17086,22335,7.6,17.5,-8053,-3.6,27.8,0,1525,1525,8281
1989,60,l) Left Censored,109394,240143,5077087,5036487,17381,7.1,23787,9.8,777126,272084,505042,5.4,15.4,706811,228552,478259,4.5,14,70315,1.4,28,0,6441,6585,53220
1989,70,a) 0,165950,167629,994645,497323,166456,198.6,0,0,990024,990024,0,199.1,199.1,0,0,0,0,0,990024,199.1,0,0,,,
1989,70,b) 1,135620,139193,1195351,1152723,1266,0.8,34852,22.2,370530,29898,340632,2.6,32.1,279351,158313,121038,13.7,24.2,91179,7.9,48.4,0,25485,25510,121902
1989,70,c) 2,123093,128761,1820249,1847368,5233,3.8,25245,18.2,282687,60510,222177,3.3,15.3,332177,197558,134619,10.7,18,-49490,-2.7,30.6,0,18837,18860,158827
1989,70,d) 3,108899,114373,1030187,1036038,4348,3.6,18570,15.3,219834,33555,186279,3.2,21.2,232544,111313,121231,10.7,22.4,-12710,-1.2,42.4,0,13556,13565,83798
1989,70,e) 4,100906,106208,1013887,1015810,3894,3.5,14606,13.1,193478,36625,156853,3.6,19,196918,87487,109431,8.6,19.4,-3440,-0.4,38,0,10275,10315,61906
1989,70,f) 5,107342,112646,980134,989603,3486,3,12498,10.7,169747,27299,142448,2.8,17.2,189146,79609,109537,8,19.1,-19399,-1.9,34.4,0,8344,8375,54113
1989,70,g) 6 to 10,315519,341637,3675772,3673083,12076,3.4,37278,10.5,621773,115958,505815,3.2,16.9,627889,259588,368301,7.1,17.1,-6116,-0.2,33.8,0,23034,23200,154089
1989,70,h) 11 to 15,104217,134967,1956265,1951721,5674,4.1,11615,8.4,306582,69108,237474,3.5,15.7,302110,108158,193952,5.5,15.5,4472,0.2,31,0,5999,6093,45957
1989,70,l) Left Censored,455420,584051,14652232,14474244,24480,4.1,43314,7.3,2084920,530268,1554652,3.7,14.4,1760848,538512,1222336,3.7,12.2,324072,2.2,24.4,0,23082,23520,176576
1990,07,a) 0,10813,10813,53731,26866,10714,198.2,0,0,53119,53119,0,197.7,197.7,0,0,0,0,0,53119,197.7,0,0,,,
1990,07,b) 1,7702,7707,45312,44401,6,0.1,1549,18,16919,55,16864,0.1,38.1,14490,5792,8698,13,32.6,2429,5.5,65.2,0,1085,1085,4150
1990,07,c) 2,6332,6345,40088,39341,318,4.7,1037,15.3,12338,1434,10904,3.6,31.4,10489,4587,5902,11.7,26.7,1849,4.7,53.4,0,731,731,3337
1990,07,d) 3,5566,5573,35452,37006,277,4.7,812,13.9,9007,1241,7766,3.4,24.3,9387,3460,5927,9.3,25.4,-380,-1.1,48.6,0,609,609,2615
1990,07,e) 4,4718,4719,31515,31775,231,4.7,584,11.9,7445,1254,6191,3.9,23.4,7956,2765,5191,8.7,25,-511,-1.6,46.8,0,426,426,1992
1990,07,f) 5,4185,4193,28748,28364,195,4.5,484,11.2,6849,1481,5368,5.2,24.1,6350,2108,4242,7.4,22.4,499,1.7,44.8,0,352,352,1623
1990,07,g) 6 to 10,13230,13270,110873,110225,696,5.2,1166,8.6,21913,4034,17879,3.7,19.9,20778,6119,14659,5.6,18.9,1135,1,37.8,0,825,825,4811
1990,07,h) 11 to 15,5884,5924,50574,50740,291,4.9,422,7,8741,1850,6891,3.6,17.2,9123,1741,7382,3.4,18,-382,-0.8,34.4,0,290,290,1220
1990,07,l) Left Censored,11653,12739,161003,161611,594,4.6,833,6.5,30264,7460,22804,4.6,18.7,31691,7595,24096,4.7,19.6,-1427,-0.9,37.4,0,525,538,3638
1990,10,a) 0,2203,2208,17208,8604,2196,198.9,0,0,17175,17175,0,199.6,199.6,0,0,0,0,0,17175,199.6,0,0,,,
1990,10,b) 1,1563,1566,19811,18835,19,1.1,405,22.8,7170,1385,5785,7.4,38.1,5098,3161,1937,16.8,27.1,2072,11,54.2,0,341,341,2910
1990,10,c) 2,1387,1390,13884,15112,64,4.2,308,20.2,3263,483,2780,3.2,21.6,5603,2966,2637,19.6,37.1,-2340,-15.5,43.2,0,262,262,2625
1990,10,d) 3,1150,1202,14579,15051,49,3.8,205,15.9,3140,731,2409,4.9,20.9,3926,1943,1983,12.9,26.1,-786,-5.2,41.8,0,169,169,1515
1990,10,e) 4,1136,1146,12411,12740,48,3.9,195,16,2806,332,2474,2.6,22,3448,1828,1620,14.3,27.1,-642,-5.1,44,0,165,165,1504
1990,10,f) 5,1150,1166,12172,12567,56,4.5,190,15.3,2724,299,2425,2.4,21.7,3362,1712,1650,13.6,26.8,-638,-5.1,43.4,0,152,152,1543
1990,10,g) 6 to 10,4955,5148,62249,63591,206,3.8,772,14.2,13126,2510,10616,3.9,20.6,16020,7092,8928,11.2,25.2,-2894,-4.6,41.2,0,581,581,4704
1990,10,h) 11 to 15,1883,2028,28141,27910,89,4.2,220,10.5,4973,965,4008,3.5,17.8,4478,1434,3044,5.1,16,495,1.8,32,0,155,155,910
1990,10,l) Left Censored,5928,10925,466251,465930,562,5,983,8.8,59952,12201,47751,2.6,12.9,59393,18221,41172,3.9,12.7,559,0.2,25.4,0,338,356,2589
1990,15,a) 0,66359,66377,320737,160369,65936,198.7,0,0,319324,319324,0,199.1,199.1,0,0,0,0,0,319324,199.1,0,0,,,
1990,15,b) 1,49556,49574,321076,315802,29,0.1,13338,23.3,118395,1974,116421,0.6,37.5,101577,50685,50892,16,32.2,16818,5.3,64.4,0,9859,9859,40966
1990,15,c) 2,42658,42711,312145,328547,2302,4.9,9400,20.1,85726,9949,75777,3,26.1,114270,50195,64075,15.3,34.8,-28544,-8.7,52.2,0,7310,7310,41078
1990,15,d) 3,38229,38251,283980,297672,2205,5.3,7606,18.4,75243,9801,65442,3.3,25.3,99851,40914,58937,13.7,33.5,-24608,-8.2,50.6,0,5873,5873,33950
1990,15,e) 4,33067,33103,261989,274182,1788,5.1,5807,16.4,63902,8137,55765,3,23.3,86011,32321,53690,11.8,31.4,-22109,-8.1,46.6,0,4490,4490,26419
1990,15,f) 5,29108,29188,256047,263960,1560,5.1,4455,14.5,62702,9058,53644,3.4,23.8,76923,27781,49142,10.5,29.1,-14221,-5.3,47.6,0,3386,3386,23067
1990,15,g) 6 to 10,86534,87057,899846,919305,5010,5.6,10340,11.5,197302,29051,168251,3.2,21.5,231860,68661,163199,7.5,25.2,-34558,-3.7,43,0,7679,7685,54296
1990,15,h) 11 to 15,49323,49562,478734,483368,3227,6.4,5239,10.3,98985,16158,82827,3.3,20.5,106045,27643,78402,5.7,21.9,-7060,-1.4,41,0,3758,3758,20715
1990,15,l) Left Censored,102776,107752,1998564,2011444,4163,3.8,9261,8.4,361781,45247,316534,2.2,18,382453,75671,306782,3.8,19,-20672,-1,36,0,6550,6575,41602
1990,20,a) 0,27581,27605,250334,125167,27503,199.3,0,0,249986,249986,0,199.7,199.7,0,0,0,0,0,249986,199.7,0,0,,,
1990,20,b) 1,22438,22571,301216,290937,207,0.8,4935,19.6,98797,18524,80273,6.4,34,77020,39969,37051,13.7,26.5,21777,7.5,53,0,3995,3996,33028
1990,20,c) 2,19483,19747,311528,325432,737,3.5,3585,16.8,65621,8920,56701,2.7,20.2,91453,49569,41884,15.2,28.1,-25832,-7.9,40.4,0,3072,3074,42057
1990,20,d) 3,17280,17435,273437,278454,722,3.9,2764,14.9,54647,7773,46874,2.8,19.6,63607,32278,31329,11.6,22.8,-8960,-3.2,39.2,0,2358,2360,28107
1990,20,e) 4,15638,15973,300646,312104,592,3.5,2150,12.8,47931,8105,39826,2.6,15.4,69955,24922,45033,8,22.4,-22024,-7,30.8,0,1834,1836,20378
1990,20,f) 5,15115,15440,347760,353947,532,3.3,1841,11.4,46268,8001,38267,2.3,13.1,59750,20414,39336,5.8,16.9,-13482,-3.8,26.2,0,1508,1508,15483
1990,20,g) 6 to 10,52675,55417,1496056,1517788,2136,3.8,4943,8.7,199796,42584,157212,2.8,13.2,244641,83450,161191,5.5,16.1,-44845,-2.9,26.4,0,3915,3927,57643
1990,20,h) 11 to 15,26924,28997,847074,854971,1099,3.7,2235,7.5,102501,21817,80684,2.6,12,117799,35009,82790,4.1,13.8,-15298,-1.8,24,0,1649,1663,19582
1990,20,l) Left Censored,100908,154128,15014541,15213191,5227,3.3,8948,5.7,1194867,266715,928152,1.8,7.9,1592831,358010,1234821,2.4,10.5,-397964,-2.6,15.8,0,4481,4556,72513
1990,40,a) 0,20420,20544,123055,61528,20452,199.1,0,0,122618,122618,0,199.3,199.3,0,0,0,0,0,122618,199.3,0,0,,,
1990,40,b) 1,15915,16172,130213,126098,130,0.7,3786,20.8,41409,5503,35906,4.4,32.8,31778,16378,15400,13,25.2,9631,7.6,50.4,0,2992,2998,12785
1990,40,c) 2,13187,13626,123953,126899,642,4.3,2663,18,29005,4847,24158,3.8,22.9,33561,16462,17099,13,26.4,-4556,-3.5,45.8,0,2209,2218,13943
1990,40,d) 3,12361,13395,135076,138763,673,4.7,2452,17.1,28932,6119,22813,4.4,20.8,35263,17653,17610,12.7,25.4,-6331,-4.6,41.6,0,2000,2003,14556
1990,40,e) 4,10101,10454,113194,124964,503,4.5,1653,14.9,23525,5322,18203,4.3,18.8,46930,11971,34959,9.6,37.6,-23405,-18.8,37.6,0,1394,1395,9860
1990,40,f) 5,8635,8882,110158,110731,377,4,1337,14.2,19895,3093,16802,2.8,18,20533,9423,11110,8.5,18.5,-638,-0.5,36,0,1103,1103,7436
1990,40,g) 6 to 10,28107,36982,806898,810109,1905,5,3905,10.3,108942,21779,87163,2.7,13.4,114361,33913,80448,4.2,14.1,-5419,-0.7,26.8,0,2772,2799,23555
1990,40,h) 11 to 15,12709,17072,315502,313506,1012,5.8,1475,8.5,48807,15972,32835,5.1,15.6,44980,13820,31160,4.4,14.3,3827,1.3,28.6,0,966,1007,8821
1990,40,l) Left Censored,35680,80756,3706822,3677531,4820,5.9,6573,8.1,453837,101209,352628,2.8,12.3,397310,134987,262323,3.7,10.8,56527,1.5,21.6,0,2052,2081,24523
1990,50,a) 0,33475,33715,163189,81595,33595,199.3,0,0,162379,162379,0,199,199,0,0,0,0,0,162379,199,0,0,,,
1990,50,b) 1,27026,27515,182758,174304,286,0.9,5226,17.2,58434,10836,47598,6.2,33.5,40378,21178,19200,12.2,23.2,18056,10.3,46.4,0,4116,4118,17210
1990,50,c) 2,22970,23765,164831,169293,1007,4,3877,15.3,38474,5904,32570,3.5,22.7,46292,24492,21800,14.5,27.3,-7818,-4.6,45.4,0,3205,3207,20801
1990,50,d) 3,21622,22760,172872,174416,959,4,3291,13.7,34761,5291,29470,3,19.9,37384,18169,19215,10.4,21.4,-2623,-1.5,39.8,0,2697,2700,14491
1990,50,e) 4,19614,20904,170656,170438,813,3.7,2572,11.8,31890,4254,27636,2.5,18.7,30981,13811,17170,8.1,18.2,909,0.5,36.4,0,2009,2014,9907
1990,50,f) 5,18443,19836,186291,186755,783,3.8,2155,10.5,31665,5382,26283,2.9,17,32362,12251,20111,6.6,17.3,-697,-0.3,34,0,1607,1615,9278
1990,50,g) 6 to 10,65427,73968,781817,783621,3088,4.1,6429,8.5,121034,24212,96822,3.1,15.4,123267,43605,79662,5.6,15.7,-2233,-0.3,30.8,0,4510,4529,28306
1990,50,h) 11 to 15,31953,39324,479112,477313,1738,4.4,2887,7.2,73382,22976,50406,4.8,15.4,69428,20671,48757,4.3,14.5,3954,0.9,29,0,1773,1798,11495
1990,50,l) Left Censored,106009,195808,4024505,4017435,9571,4.8,12658,6.4,518378,144854,373524,3.6,12.9,502902,157286,345616,3.9,12.5,15476,0.4,25,0,4643,4750,42539
1990,52,a) 0,113626,115714,825595,412798,115304,199.3,0,0,823522,823522,0,199.5,199.5,0,0,0,0,0,823522,199.5,0,0,,,
1990,52,b) 1,89788,94152,786802,823473,1347,1.3,23091,21.8,189787,21290,168497,2.6,23,255390,137846,117544,16.7,31,-65603,-8,46,0,19259,19266,117221
1990,52,c) 2,74934,79797,694759,742963,3848,4.4,17253,19.8,134506,29454,105052,4,18.1,225189,119862,105327,16.1,30.3,-90683,-12.2,36.2,0,14475,14525,101432
1990,52,d) 3,67953,74765,697595,732479,3669,4.6,14556,18.1,125419,31652,93767,4.3,17.1,191654,99216,92438,13.5,26.2,-66235,-9.1,34.2,0,11905,11953,78316
1990,52,e) 4,58848,65703,620462,650518,3121,4.5,11142,15.9,101322,26843,74479,4.1,15.6,158953,76673,82280,11.8,24.4,-57631,-8.8,31.2,0,8984,9034,61358
1990,52,f) 5,51713,58710,575682,597119,2712,4.4,8969,14.5,90067,25161,64906,4.2,15.1,131625,60032,71593,10.1,22,-41558,-6.9,30.2,0,7023,7050,46693
1990,52,g) 6 to 10,175014,209604,2306282,2368614,10107,4.6,25498,11.7,340855,102740,238115,4.3,14.4,461073,194468,266605,8.2,19.5,-120218,-5.1,28.8,0,18520,18774,138359
1990,52,h) 11 to 15,85943,125002,1535887,1555025,6254,4.9,12071,9.4,225650,78359,147291,5,14.5,262082,90702,171380,5.8,16.9,-36432,-2.4,29,0,7101,7346,49479
1990,52,l) Left Censored,220827,567573,11595039,11562105,33808,5.9,44694,7.8,1588303,568078,1020225,4.9,13.7,1524583,471029,1053554,4.1,13.2,63720,0.5,26.4,0,16854,17332,117505
1990,60,a) 0,36354,36618,171251,85626,36430,199,0,0,170620,170620,0,199.3,199.3,0,0,0,0,0,170620,199.3,0,0,,,
1990,60,b) 1,28980,29448,178180,175843,268,0.8,6828,20.6,59147,8341,50806,4.7,33.6,52326,29118,23208,16.6,29.8,6821,3.8,59.6,0,5311,5318,22177
1990,60,c) 2,24856,25276,158765,165332,1113,4.1,4690,17.2,40028,7097,32931,4.3,24.2,51298,28328,22970,17.1,31,-11270,-6.8,48.4,0,3736,3743,21850
1990,60,d) 3,23766,24323,156255,161929,1187,4.6,4193,16.1,32450,6368,26082,3.9,20,42182,22330,19852,13.8,26,-9732,-6,40,0,3388,3401,18811
1990,60,e) 4,20258,20498,131505,137716,921,4.3,3031,14,24634,4562,20072,3.3,17.9,35528,19172,16356,13.9,25.8,-10894,-7.9,35.8,0,2384,2388,14335
1990,60,f) 5,18774,19703,145715,150048,933,4.5,2500,12.2,26018,7100,18918,4.7,17.3,34459,15805,18654,10.5,23,-8441,-5.7,34.6,0,1962,1964,12192
1990,60,g) 6 to 10,64027,66330,543534,549932,3087,4.5,6867,10,85908,23142,62766,4.2,15.6,97957,43602,54355,7.9,17.8,-12049,-2.2,31.2,0,5111,5126,27964
1990,60,h) 11 to 15,31819,34624,300234,301256,1992,5.7,2976,8.5,43493,12767,30726,4.2,14.4,44555,16359,28196,5.4,14.8,-1062,-0.4,28.8,0,2049,2060,11284
1990,60,l) Left Censored,105329,238974,5091608,5082267,15361,6.4,16441,6.9,720142,234655,485487,4.6,14.2,702991,192325,510666,3.8,13.8,17151,0.4,27.6,0,4802,4994,36077
1990,70,a) 0,170004,171648,1002642,501321,170909,199.1,0,0,1000287,1000287,0,199.5,199.5,0,0,0,0,0,1000287,199.5,0,0,,,
1990,70,b) 1,135305,137661,1097150,1051009,964,0.6,27315,17.9,353308,28624,324684,2.7,33.6,250874,125929,124945,12,23.9,102434,9.7,47.8,0,21109,21126,102347
1990,70,c) 2,118251,122416,1148249,1168947,5741,4.4,20239,15.5,247108,41480,205628,3.5,21.1,279904,131422,148482,11.2,23.9,-32796,-2.8,42.2,0,16273,16293,107613
1990,70,d) 3,109958,115970,1813471,1818073,5492,4.5,16900,13.8,235042,37993,197049,2.1,12.9,239345,108321,131024,6,13.2,-4303,-0.3,25.8,0,13372,13404,85482
1990,70,e) 4,99258,104804,1018728,1023036,4702,4.3,13208,12.1,206491,34215,172276,3.3,20.2,212381,95609,116772,9.3,20.8,-5890,-0.6,40.4,0,10236,10257,70303
1990,70,f) 5,93021,98693,1010449,1011572,4323,4.2,11136,10.9,173549,33320,140229,3.3,17.2,171515,69673,101842,6.9,17,2034,0.2,34,0,8342,8365,51730
1990,70,g) 6 to 10,350674,377770,4010991,4005239,16903,4.4,31721,8.2,653683,149783,503900,3.7,16.3,637268,223308,413960,5.6,15.9,16415,0.4,31.8,0,22407,22499,141268
1990,70,h) 11 to 15,152117,189490,2649659,2629671,9144,4.8,12896,6.7,432766,87966,344800,3.3,16.5,380475,124774,255701,4.7,14.5,52291,2,29,0,7981,8090,68784
1990,70,l) Left Censored,438247,572526,14947176,14808109,23826,4.1,34806,6,1872406,422180,1450226,2.9,12.6,1598536,439616,1158920,3,10.8,273870,1.8,21.6,0,20193,20428,150013
1991,07,a) 0,9654,9657,46054,23027,9542,197.6,0,0,45631,45631,0,198.2,198.2,0,0,0,0,0,45631,198.2,0,0,,,
1991,07,b) 1,8724,8725,75664,65228,5,0.1,1945,19.9,40295,29,40266,0,61.8,18674,7435,11239,11.4,28.6,21621,33.2,57.2,0,1021,1021,3357
1991,07,c) 2,6775,6781,38868,41528,166,2.3,1009,14,9921,1081,8840,2.6,23.9,15204,6465,8739,15.6,36.6,-5283,-12.7,47.8,0,651,651,5138
1991,07,d) 3,5661,5683,35949,37842,187,3.1,837,13.9,8636,865,7771,2.3,22.8,12598,4135,8463,10.9,33.3,-3962,-10.5,45.6,0,536,536,2762
1991,07,e) 4,4984,4990,33553,34419,150,2.8,736,13.9,7599,544,7055,1.6,22.1,9382,3291,6091,9.6,27.3,-1783,-5.2,44.2,0,502,504,2372
1991,07,f) 5,4277,4279,28817,30018,137,3,589,13.1,6357,860,5497,2.9,21.2,8838,2889,5949,9.6,29.4,-2481,-8.2,42.4,0,391,391,1961
1991,07,g) 6 to 10,14391,14431,115328,118237,414,2.8,1378,9.3,19445,1878,17567,1.6,16.4,26779,6621,20158,5.6,22.6,-7334,-6.2,32.8,0,927,928,4574
1991,07,h) 11 to 15,7684,7733,64809,66800,227,2.9,571,7.2,9118,867,8251,1.3,13.6,13146,3086,10060,4.6,19.7,-4028,-6.1,27.2,0,365,365,2176
1991,07,l) Left Censored,11201,12318,178356,169335,457,3.7,872,7,47375,8013,39362,4.7,28,29616,6467,23149,3.8,17.5,17759,10.5,35,0,537,537,3348
1991,10,a) 0,2161,2167,18154,9077,2147,198.2,0,0,18091,18091,0,199.3,199.3,0,0,0,0,0,18091,199.3,0,0,,,
1991,10,b) 1,1742,1750,20049,19020,19,1,445,22.5,7088,487,6601,2.6,37.3,4940,2738,2202,14.4,26,2148,11.3,52,0,313,313,2248
1991,10,c) 2,1324,1330,15500,17445,40,2.8,261,18.1,3095,524,2571,3,17.7,6909,3169,3740,18.2,39.6,-3814,-21.9,35.4,0,220,220,2447
1991,10,d) 3,1183,1191,11819,12817,39,3,244,18.9,2119,221,1898,1.7,16.5,4117,1960,2157,15.3,32.1,-1998,-15.6,33,0,200,200,1638
1991,10,e) 4,1020,1072,14315,14461,40,3.5,171,15,2780,482,2298,3.3,19.2,3098,1204,1894,8.3,21.4,-318,-2.2,38.4,0,124,124,882
1991,10,f) 5,1028,1039,10667,11230,48,4.4,164,15,1578,229,1349,2,14.1,2745,1256,1489,11.2,24.4,-1167,-10.3,28.2,0,131,131,945
1991,10,g) 6 to 10,4992,5191,61987,63900,224,4.2,640,11.9,10603,2161,8442,3.4,16.6,14440,5614,8826,8.8,22.6,-3837,-6,33.2,0,457,457,4394
1991,10,h) 11 to 15,2456,2616,34382,35390,112,4.1,294,10.9,5734,1645,4089,4.6,16.2,7796,3250,4546,9.2,22,-2062,-5.8,32.4,0,184,184,1743
1991,10,l) Left Censored,5612,10576,461090,463883,562,5.2,962,9,57606,18640,38966,4,12.4,64679,20043,44636,4.3,13.9,-7073,-1.5,24.8,0,338,341,2580
1991,15,a) 0,58761,58809,254930,127465,58102,197.6,0,0,252743,252743,0,198.3,198.3,0,0,0,0,0,252743,198.3,0,0,,,
1991,15,b) 1,49854,49878,278821,299294,37,0.1,15038,25.9,88226,2195,86031,0.7,29.5,124905,57349,67556,19.2,41.7,-36679,-12.2,59,0,9378,9378,39101
1991,15,c) 2,41046,41064,244766,282620,1547,3.4,9725,21.5,58531,5472,53059,1.9,20.7,133109,51824,81285,18.3,47.1,-74578,-26.4,41.4,0,6482,6486,38588
1991,15,d) 3,35886,35944,249384,280630,1410,3.6,8016,20.4,47806,4996,42810,1.8,17,110833,40636,70197,14.5,39.5,-63027,-22.5,34,0,5556,5556,31819
1991,15,e) 4,32560,32587,225004,254694,1243,3.5,6854,19.3,43299,4516,38783,1.8,17,103393,38123,65270,15,40.6,-60094,-23.6,34,0,4748,4748,29890
1991,15,f) 5,28814,28844,212503,237359,1043,3.4,5287,17.1,38891,3511,35380,1.5,16.4,88600,27854,60746,11.7,37.3,-49709,-20.9,32.8,0,3656,3659,20835
1991,15,g) 6 to 10,89307,89665,820464,903652,3272,3.5,13217,14,134357,13688,120669,1.5,14.9,302416,78061,224355,8.6,33.5,-168059,-18.6,29.8,0,8922,8925,56602
1991,15,h) 11 to 15,60353,60851,551880,599567,2377,3.7,7675,12.1,84344,9087,75257,1.5,14.1,182506,39272,143234,6.6,30.4,-98162,-16.3,28.2,0,4929,4933,26978
1991,15,l) Left Censored,95440,100376,1756044,1878224,2692,2.6,10073,9.7,240146,33192,206954,1.8,12.8,480773,87227,393546,4.6,25.6,-240627,-12.8,25.6,0,6688,6715,40468
1991,20,a) 0,25999,26032,217663,108832,25818,198.4,0,0,215452,215452,0,198,198,0,0,0,0,0,215452,198,0,0,,,
1991,20,b) 1,22087,22184,257598,250250,204,0.8,5163,20.8,87241,21040,66201,8.4,34.9,71400,40553,30847,16.2,28.5,15841,6.4,57,0,3881,3881,32032
1991,20,c) 2,19222,19394,260592,279332,537,2.6,3598,17.2,50285,6633,43652,2.4,18,87790,46574,41216,16.7,31.4,-37505,-13.4,36,0,2906,2907,38422
1991,20,d) 3,17062,17457,281664,295900,576,3.1,2875,15.5,46139,7312,38827,2.5,15.6,74902,32517,42385,11,25.3,-28763,-9.7,31.2,0,2324,2328,25745
1991,20,e) 4,15450,15625,251872,262196,395,2.4,2289,13.8,38426,4760,33666,1.8,14.7,61141,27210,33931,10.4,23.3,-22715,-8.6,29.4,0,1839,1840,23004
1991,20,f) 5,14222,14558,280897,290473,356,2.3,1814,11.9,38798,6349,32449,2.2,13.4,57708,22286,35422,7.7,19.9,-18910,-6.5,26.8,0,1437,1440,16131
1991,20,g) 6 to 10,54204,56755,1478070,1536115,1319,2.2,5584,9.5,171727,28294,143433,1.8,11.2,279123,83580,195543,5.4,18.2,-107396,-7,22.4,0,4193,4225,53823
1991,20,h) 11 to 15,34071,36868,1023207,1058051,934,2.5,3043,8,110769,23665,87104,2.2,10.5,173044,49689,123355,4.7,16.4,-62275,-5.9,21,0,2116,2139,29576
1991,20,l) Left Censored,95922,148899,14238874,14635173,4072,2.7,9436,6.2,1065502,261112,804390,1.8,7.3,1835079,442614,1392465,3,12.5,-769577,-5.2,14.6,0,4581,4756,104541
1991,40,a) 0,20075,20409,110247,55124,20227,198.2,0,0,109523,109523,0,198.7,198.7,0,0,0,0,0,109523,198.7,0,0,,,
1991,40,b) 1,16259,16572,123203,122640,248,1.3,3738,20.2,39285,10266,29019,8.4,32,37132,16706,20426,13.6,30.3,2153,1.7,60.6,0,2662,2662,12199
1991,40,c) 2,13523,13884,112316,119077,496,3.3,2604,17.4,23930,3614,20316,3,20.1,37388,17727,19661,14.9,31.4,-13458,-11.3,40.2,0,2004,2004,14577
1991,40,d) 3,11323,11907,111581,116401,457,3.6,2068,16.3,22046,5142,16904,4.4,18.9,32090,14326,17764,12.3,27.6,-10044,-8.7,37.8,0,1627,1630,12417
1991,40,e) 4,10679,11983,120174,126251,685,5.4,2057,16.3,21728,4882,16846,3.9,17.2,34447,17079,17368,13.5,27.3,-12719,-10.1,34.4,0,1550,1565,13387
1991,40,f) 5,8854,9367,104788,108509,413,4.2,1465,14.8,17886,4459,13427,4.1,16.5,25664,11457,14207,10.6,23.7,-7778,-7.2,33,0,1177,1180,9141
1991,40,g) 6 to 10,29017,38450,791675,811980,1966,5,4563,11.5,102437,27827,74610,3.4,12.6,143590,45619,97971,5.6,17.7,-41153,-5.1,25.2,0,3089,3098,26012
1991,40,h) 11 to 15,16092,21774,404013,398164,1651,7.5,1893,8.7,72252,22874,49378,5.7,18.1,60983,16723,44260,4.2,15.3,11269,2.8,30.6,0,1253,1260,10046
1991,40,l) Left Censored,33559,82292,3706872,3707516,8793,10.8,7623,9.3,553163,222757,330406,6,14.9,558160,159353,398807,4.3,15.1,-4997,-0.2,29.8,0,2025,2423,32770
1991,50,a) 0,33588,33897,150709,75355,33648,198.5,0,0,149489,149489,0,198.4,198.4,0,0,0,0,0,149489,198.4,0,0,,,
1991,50,b) 1,27890,28353,165358,162969,338,1.1,5353,17.3,49310,6292,43018,3.9,30.3,43729,20714,23015,12.7,26.8,5581,3.5,53.6,0,3835,3840,15659
1991,50,c) 2,23767,24387,159608,169254,744,2.9,3780,14.6,33141,4883,28258,2.9,19.6,52448,23845,28603,14.1,31,-19307,-11.4,39.2,0,2879,2883,19707
1991,50,d) 3,20565,21470,152979,159102,700,3.1,3037,13.4,26754,3645,23109,2.3,16.8,39583,16939,22644,10.6,24.9,-12829,-8.1,33.6,0,2338,2347,13033
1991,50,e) 4,19516,20717,162148,167116,615,2.8,2758,12.7,25331,3532,21799,2.1,15.2,36425,15300,21125,9.2,21.8,-11094,-6.6,30.4,0,2078,2089,10957
1991,50,f) 5,17896,19214,159234,164051,583,2.9,2269,11.3,23678,3540,20138,2.2,14.4,33350,12154,21196,7.4,20.3,-9672,-5.9,28.8,0,1672,1684,8882
1991,50,g) 6 to 10,67946,76476,797445,823156,2612,3.3,7648,9.7,110429,23094,87335,2.8,13.4,161365,60918,100447,7.4,19.6,-50936,-6.2,26.8,0,4983,5044,35168
1991,50,h) 11 to 15,40179,49301,575064,589438,2011,4,4173,8.3,74227,21098,53129,3.6,12.6,102371,29930,72441,5.1,17.4,-28144,-4.8,25.2,0,2386,2430,17497
1991,50,l) Left Censored,100761,191337,3902548,3964023,9274,4.8,14019,7.2,459483,149232,310251,3.8,11.6,582159,177782,404377,4.5,14.7,-122676,-3.1,23.2,0,4860,5045,46736
1991,52,a) 0,112931,115533,781822,390911,114804,198.7,0,0,778081,778081,0,199,199,0,0,0,0,0,778081,199,0,0,,,
1991,52,b) 1,90530,93667,739868,783854,1336,1.3,22328,21.3,170361,26523,143838,3.4,21.7,254200,127531,126669,16.3,32.4,-83839,-10.7,43.4,0,17131,17166,104395
1991,52,c) 2,75393,80284,662082,722642,2984,3.4,16587,19,108547,21713,86834,3,15,229815,115585,114230,16,31.8,-121268,-16.8,30,0,13233,13386,95536
1991,52,d) 3,64266,69513,609408,652116,2714,3.6,13025,17.5,97914,23864,74050,3.7,15,185071,89507,95564,13.7,28.4,-87157,-13.4,30,0,10322,10371,71547
1991,52,e) 4,58855,65438,611510,654132,2669,3.8,12175,17.4,91064,24030,67034,3.7,13.9,179487,85140,94347,13,27.4,-88423,-13.5,27.8,0,8909,9397,64184
1991,52,f) 5,51332,58542,555207,587941,2447,3.9,9835,15.8,81847,22942,58905,3.9,13.9,148467,67167,81300,11.4,25.3,-66620,-11.4,27.8,0,7368,7436,51557
1991,52,g) 6 to 10,179154,214894,2286840,2392207,8568,3.8,27635,12.3,305761,93994,211767,3.9,12.8,519172,208049,311123,8.7,21.7,-213411,-8.9,25.6,0,19365,19764,143617
1991,52,h) 11 to 15,105308,149719,1796750,1856874,6645,4.3,15790,10.2,233938,81989,151949,4.4,12.6,354300,121833,232467,6.6,19.1,-120362,-6.5,25.2,0,8816,9300,64949
1991,52,l) Left Censored,205247,551362,11364670,11477742,29867,5.3,46914,8.4,1451754,554465,897289,4.8,12.6,1679371,496827,1182544,4.3,14.6,-227617,-2,25.2,0,15564,16978,127278
1991,60,a) 0,34895,36634,179050,89525,36286,198.1,0,0,177718,177718,0,198.5,198.5,0,0,0,0,0,177718,198.5,0,0,,,
1991,60,b) 1,28318,29592,176143,174618,934,2.8,7140,21.7,65573,20803,44770,11.9,37.6,60903,30942,29961,17.7,34.9,4670,2.7,69.8,0,5029,5034,22775
1991,60,c) 2,24093,25086,145831,157721,1236,4.6,5035,18.6,35917,9093,26824,5.8,22.8,59305,30598,28707,19.4,37.6,-23388,-14.8,45.6,0,3769,3770,24213
1991,60,d) 3,21221,22387,136237,145097,1365,5.8,3879,16.4,31450,10035,21415,6.9,21.7,48596,21579,27017,14.9,33.5,-17146,-11.8,43.4,0,2965,2967,18301
1991,60,e) 4,20716,21910,129307,139675,1293,5.6,3508,15.3,24892,8930,15962,6.4,17.8,44648,20636,24012,14.8,32,-19756,-14.2,35.6,0,2679,2682,16811
1991,60,f) 5,17910,18806,117256,122453,1149,5.9,2688,13.7,26406,12870,13536,10.5,21.6,37081,16287,20794,13.3,30.3,-10675,-8.7,43.2,0,2056,2061,13533
1991,60,g) 6 to 10,65979,72833,542430,565818,5817,7.9,7758,10.5,111497,58463,53034,10.3,19.7,158452,60878,97574,10.8,28,-46955,-8.3,39.4,0,5337,5358,41454
1991,60,h) 11 to 15,40730,47763,410600,418399,4859,10.3,3836,8.1,82397,48608,33789,11.6,19.7,98193,26473,71720,6.3,23.5,-15796,-3.8,39.4,0,2608,2612,18410
1991,60,l) Left Censored,99862,250768,5031069,5051453,30135,12.3,19249,7.8,902450,464017,438433,9.2,17.9,946953,271036,675917,5.4,18.7,-44503,-0.8,35.8,0,5366,5605,79311
1991,70,a) 0,172600,174244,975884,487942,172882,198.4,0,0,970091,970091,0,198.8,198.8,0,0,0,0,0,970091,198.8,0,0,,,
1991,70,b) 1,141037,143825,1071983,1041474,1459,0.9,26819,17,334470,30339,304131,2.9,32.1,267058,122706,144352,11.8,25.6,67412,6.5,51.2,0,18213,18222,88542
1991,70,c) 2,119213,122173,998606,1042293,4023,3.1,19028,14.7,213968,30412,183556,2.9,20.5,299853,139297,160556,13.4,28.8,-85885,-8.3,41,0,14149,14205,113703
1991,70,d) 3,105587,110259,1092100,1124496,3939,3.4,15924,13.7,186633,31931,154702,2.8,16.6,255507,109935,145572,9.8,22.7,-68874,-6.1,33.2,0,11892,11940,90045
1991,70,e) 4,99264,105742,1722774,1763134,3884,3.5,14297,12.9,185865,39368,146497,2.2,10.5,272365,133910,138455,7.6,15.4,-86500,-4.9,21,0,10498,10586,104491
1991,70,f) 5,90522,96428,957352,993413,3307,3.3,11781,11.7,157163,31175,125988,3.1,15.8,228642,99695,128947,10,23,-71479,-7.2,31.6,0,8513,8582,78459
1991,70,g) 6 to 10,366755,397379,4224073,4301577,13677,3.4,35879,8.8,620931,135723,485208,3.2,14.4,783256,259551,523705,6,18.2,-162325,-3.8,28.8,0,24149,24463,168055
1991,70,h) 11 to 15,195328,238848,3203203,3217994,9633,4,17714,7.3,453927,109478,344449,3.4,14.1,490542,150032,340510,4.7,15.2,-36615,-1.1,28.2,0,10280,10531,75862
1991,70,l) Left Censored,421078,559510,14961518,14966629,20989,3.7,35454,6.3,1709091,422005,1287086,2.8,11.4,1743773,460258,1283515,3.1,11.7,-34682,-0.3,22.8,0,18873,19149,149275
1992,07,a) 0,9444,9458,38219,19110,9421,199.2,0,0,38137,38137,0,199.6,199.6,0,0,0,0,0,38137,199.6,0,0,,,
1992,07,b) 1,7489,7498,45900,46956,11,0.1,1943,22.6,15776,120,15656,0.3,33.6,17015,9261,7754,19.7,36.2,-1239,-2.6,67.2,0,1249,1249,4165
1992,07,c) 2,7466,7467,47403,58129,336,4.2,1366,17,14497,1983,12514,3.4,24.9,35455,26515,8940,45.6,61,-20958,-36.1,49.8,0,900,900,3957
1992,07,d) 3,5949,5956,36322,37087,182,2.9,895,14.1,8952,706,8246,1.9,24.1,10196,4142,6054,11.2,27.5,-1244,-3.4,48.2,0,611,611,3040
1992,07,e) 4,5080,5099,32898,33464,159,3,645,12,7098,413,6685,1.2,21.2,7930,2611,5319,7.8,23.7,-832,-2.5,42.4,0,443,443,1661
1992,07,f) 5,4567,4577,34004,33978,159,3.3,527,11,7963,627,7336,1.8,23.4,7808,2534,5274,7.5,23,155,0.4,46,0,363,363,1632
1992,07,g) 6 to 10,15311,15353,118576,120632,469,3,1392,8.8,21658,1832,19826,1.5,18,25211,7827,17384,6.5,20.9,-3553,-2.9,36,0,947,947,5216
1992,07,h) 11 to 15,9501,9558,83349,84125,298,3,724,7.4,13415,1160,12255,1.4,15.9,14642,3614,11028,4.3,17.4,-1227,-1.5,31.8,0,469,475,2426
1992,07,l) Left Censored,10657,11799,164268,158630,488,4.1,847,7.1,33958,12595,21363,7.9,21.4,22277,5843,16434,3.7,14,11681,7.4,28,0,530,531,2339
1992,10,a) 0,1749,1759,14256,7128,1757,199.8,0,0,14254,14254,0,200,200,0,0,0,0,0,14254,200,0,0,,,
1992,10,b) 1,1561,1574,14746,15937,22,1.2,563,30.2,4473,1247,3226,7.8,28.1,6736,3950,2786,24.8,42.3,-2263,-14.2,56.2,0,448,448,3439
1992,10,c) 2,1384,1392,14474,17121,57,3.6,366,23.4,2078,201,1877,1.2,12.1,7305,3585,3720,20.9,42.7,-5227,-30.6,24.2,0,296,296,3066
1992,10,d) 3,1093,1101,12242,13827,24,2,227,18.7,2403,192,2211,1.4,17.4,5463,3035,2428,21.9,39.5,-3060,-22.1,34.8,0,195,195,2765
1992,10,e) 4,994,1000,8764,9960,34,3.1,205,18.8,1255,125,1130,1.3,12.6,3607,1719,1888,17.3,36.2,-2352,-23.6,25.2,0,185,185,1627
1992,10,f) 5,896,947,11867,12689,31,3.1,145,14.4,2146,430,1716,3.4,16.9,3756,1062,2694,8.4,29.6,-1610,-12.7,33.8,0,114,115,772
1992,10,g) 6 to 10,4452,4616,48446,52685,183,3.8,656,13.5,6709,1570,5139,3,12.7,14738,4405,10333,8.4,28,-8029,-15.3,25.4,0,466,468,3073
1992,10,h) 11 to 15,3220,3455,44873,46980,161,4.5,385,10.8,7404,2882,4522,6.1,15.8,11524,3481,8043,7.4,24.5,-4120,-8.7,31.6,0,268,270,1641
1992,10,l) Left Censored,5254,9964,429269,447205,480,4.7,1099,10.7,56312,15797,40515,3.5,12.6,90691,29122,61569,6.5,20.3,-34379,-7.7,25.2,0,332,348,3025
1992,15,a) 0,57761,57790,244597,122299,57538,199.1,0,0,243880,243880,0,199.4,199.4,0,0,0,0,0,243880,199.4,0,0,,,
1992,15,b) 1,42398,42458,237452,245197,31,0.1,14223,28.1,82511,1241,81270,0.5,33.7,92607,49105,43502,20,37.8,-10096,-4.1,67.4,0,10357,10357,38543
1992,15,c) 2,40861,40894,235880,256804,2320,5.1,10013,22.1,65508,7661,57847,3,25.5,103390,47404,55986,18.5,40.3,-37882,-14.8,51,0,7351,7352,37865
1992,15,d) 3,34939,34976,214169,230549,1999,5.3,7273,19.1,53901,6539,47362,2.8,23.4,84060,33417,50643,14.5,36.5,-30159,-13.1,46.8,0,5357,5358,26037
1992,15,e) 4,31183,31236,201258,214164,1728,5.1,5836,17.4,48783,5696,43087,2.7,22.8,72722,28534,44188,13.3,34,-23939,-11.2,45.6,0,4230,4233,22529
1992,15,f) 5,28732,28767,203131,214078,1507,4.9,4788,15.6,45334,5095,40239,2.4,21.2,65692,21411,44281,10,30.7,-20358,-9.5,42.4,0,3396,3397,16356
1992,15,g) 6 to 10,94263,94583,801168,838113,4415,4.4,12665,12.7,161598,15471,146127,1.8,19.3,230168,64024,166144,7.6,27.5,-68570,-8.2,38.6,0,8794,8795,46944
1992,15,h) 11 to 15,68593,69217,646265,676347,3160,4.4,8121,11.2,118549,11900,106649,1.8,17.5,172162,39476,132686,5.8,25.5,-53613,-8,35,0,5470,5477,26900
1992,15,l) Left Censored,88723,93572,1670587,1726316,2713,2.8,9021,9.3,275333,25323,250010,1.5,15.9,383779,66406,317373,3.8,22.2,-108446,-6.3,31.8,0,6120,6140,34107
1992,20,a) 0,24447,24531,215300,107650,24459,199.4,0,0,215016,215016,0,199.7,199.7,0,0,0,0,0,215016,199.7,0,0,,,
1992,20,b) 1,20061,20206,240134,229166,221,1,5486,23.8,88022,24366,63656,10.6,38.4,64495,40602,23893,17.7,28.1,23527,10.3,56.2,0,4524,4525,34264
1992,20,c) 2,18457,18568,228204,240609,670,3.3,3879,19.1,50899,6305,44594,2.6,21.2,73792,44063,29729,18.3,30.7,-22893,-9.5,42.4,0,3237,3238,38247
1992,20,d) 3,16648,16838,235817,244022,539,3,2765,15.3,45252,5010,40242,2.1,18.5,60276,31740,28536,13,24.7,-15024,-6.2,37,0,2273,2286,27889
1992,20,e) 4,15029,15331,271103,274920,455,2.8,2367,14.5,46952,5296,41656,1.9,17.1,55090,27091,27999,9.9,20,-8138,-2.9,34.2,0,1831,1832,21101
1992,20,f) 5,13917,14118,241340,244535,410,2.8,1758,11.9,38152,4799,33353,2,15.6,44019,16508,27511,6.8,18,-5867,-2.4,31.2,0,1453,1458,13910
1992,20,g) 6 to 10,53898,56097,1356173,1368443,1411,2.4,5494,9.4,187460,24772,162688,1.8,13.7,210906,69810,141096,5.1,15.4,-23446,-1.7,27.4,0,4219,4235,47536
1992,20,h) 11 to 15,41327,44960,1366936,1383187,1032,2.2,3486,7.5,159793,26084,133709,1.9,11.6,188876,55897,132979,4,13.7,-29083,-2.1,23.2,0,2478,2491,29792
1992,20,l) Left Censored,91202,142970,13884638,14072504,3050,2.1,9086,6.2,1176249,214767,961482,1.5,8.4,1541076,386817,1154259,2.7,11,-364827,-2.6,16.8,0,4223,4352,70431
1992,40,a) 0,20524,21544,113939,56970,21458,199.2,0,0,113736,113736,0,199.6,199.6,0,0,0,0,0,113736,199.6,0,0,,,
1992,40,b) 1,15264,15804,114105,111995,302,1.7,4283,23.8,41063,5265,35798,4.7,36.7,35220,19371,15849,17.3,31.4,5843,5.3,62.8,0,3355,3358,14795
1992,40,c) 2,13374,13886,105846,112664,729,4.8,2992,19.7,25602,4151,21451,3.7,22.7,38126,18524,19602,16.4,33.8,-12524,-11.1,45.4,0,2422,2423,15460
1992,40,d) 3,11429,11947,104970,108316,598,4.6,2249,17.5,22443,4138,18305,3.8,20.7,28319,13600,14719,12.6,26.1,-5876,-5.4,41.4,0,1814,1819,11412
1992,40,e) 4,9809,10567,99458,104258,619,5.5,1785,15.9,22107,6793,15314,6.5,21.2,31334,13593,17741,13,30.1,-9227,-8.9,42.4,0,1376,1393,10333
1992,40,f) 5,9443,10954,110694,113537,688,6,1572,13.7,22384,4531,17853,4,19.7,28104,12834,15270,11.3,24.8,-5720,-5.1,39.4,0,1141,1162,8418
1992,40,g) 6 to 10,30024,40169,787956,800125,2470,6,4478,10.8,119497,30765,88732,3.8,14.9,131878,40305,91573,5,16.5,-12381,-1.6,29.8,0,3017,3037,23424
1992,40,h) 11 to 15,19280,26326,464317,474175,2120,8,2624,9.8,82619,22267,60352,4.7,17.4,99909,35309,64600,7.4,21.1,-17290,-3.7,34.8,0,1460,1576,19157
1992,40,l) Left Censored,31836,82918,3595602,3657846,7036,8.5,6774,8.2,434546,155563,278983,4.3,11.9,559454,141690,417764,3.9,15.3,-124908,-3.4,23.8,0,1809,1877,18422
1992,50,a) 0,33051,33678,146485,73243,33600,199.5,0,0,146253,146253,0,199.7,199.7,0,0,0,0,0,146253,199.7,0,0,,,
1992,50,b) 1,26584,27174,167790,158642,376,1.2,6399,21,62709,8247,54462,5.2,39.5,43184,24979,18205,15.7,27.2,19525,12.3,54.4,0,5070,5072,20527
1992,50,c) 2,23685,24179,148616,153966,879,3.4,4342,16.6,33649,3920,29729,2.5,21.9,43345,23323,20022,15.1,28.2,-9696,-6.3,43.8,0,3578,3591,20021
1992,50,d) 3,20734,21395,150908,153154,756,3.3,3304,14.5,31703,3304,28399,2.2,20.7,35412,17045,18367,11.1,23.1,-3709,-2.4,41.4,0,2708,2713,14343
1992,50,e) 4,18302,19351,150037,150528,705,3.5,2498,12.3,30836,5704,25132,3.8,20.5,31321,13604,17717,9,20.8,-485,-0.3,41,0,1918,1920,10542
1992,50,f) 5,17537,18752,154700,156917,617,3.1,2360,12,26814,3467,23347,2.2,17.1,30835,12302,18533,7.8,19.7,-4021,-2.6,34.2,0,1710,1733,9189
1992,50,g) 6 to 10,67991,76056,763063,776028,2465,3.1,7909,10,115146,18781,96365,2.4,14.8,139005,52383,86622,6.8,17.9,-23859,-3.1,29.6,0,5155,5319,31316
1992,50,h) 11 to 15,49229,60461,724488,734485,2239,3.6,5103,8.2,97555,19726,77829,2.7,13.3,115735,36852,78883,5,15.8,-18180,-2.5,26.6,0,2908,3066,21313
1992,50,l) Left Censored,95746,183963,3743160,3835331,7329,3.9,15866,8.4,496002,135275,360727,3.5,12.9,674260,227369,446891,5.9,17.6,-178258,-4.7,25.8,0,4644,5382,42536
1992,52,a) 0,110158,113702,762236,381118,113488,199.6,0,0,761533,761533,0,199.8,199.8,0,0,0,0,0,761533,199.8,0,0,,,
1992,52,b) 1,84811,88559,684942,728583,1659,1.6,26144,25.7,166828,27117,139711,3.7,22.9,246862,140231,106631,19.2,33.9,-80034,-11,45.8,0,21870,21896,120659
1992,52,c) 2,73571,77568,619893,670748,3642,4.3,18159,21.3,112851,24919,87932,3.7,16.8,209770,113089,96681,16.9,31.3,-96919,-14.5,33.6,0,15200,15272,94945
1992,52,d) 3,63207,68838,588473,621359,3247,4.4,13678,18.4,102553,26568,75985,4.3,16.5,165198,85975,79223,13.8,26.6,-62645,-10.1,33,0,11104,11281,68602
1992,52,e) 4,55123,60943,546398,574945,2663,4.1,10648,16.3,88620,22686,65934,3.9,15.4,143161,71184,71977,12.4,24.9,-54541,-9.5,30.8,0,8425,8538,55544
1992,52,f) 5,51366,57924,557157,581869,2554,4.1,9632,15.6,88368,21406,66962,3.7,15.2,136061,62148,73913,10.7,23.4,-47693,-8.2,30.4,0,7077,7325,46139
1992,52,g) 6 to 10,180223,214554,2253485,2326595,9369,4.2,29146,13,328222,85996,242226,3.7,14.1,468486,202040,266446,8.7,20.1,-140264,-6,28.2,0,19460,20358,134440
1992,52,h) 11 to 15,125505,178245,2176936,2213854,8791,4.8,19476,10.6,312907,101826,211081,4.6,14.1,381778,138510,243268,6.3,17.2,-68871,-3.1,28.2,0,10233,11165,73759
1992,52,l) Left Censored,192234,534797,11150868,11292715,30446,5.6,49924,9.2,1431484,519714,911770,4.6,12.7,1697976,535863,1162113,4.7,15,-266492,-2.3,25.4,0,13969,15820,109664
1992,60,a) 0,33788,34658,134005,67003,34511,199.2,0,0,133530,133530,0,199.3,199.3,0,0,0,0,0,133530,199.3,0,0,,,
1992,60,b) 1,26826,29020,178787,174589,689,2.1,7217,22.1,66307,10725,55582,6.1,38,56474,29984,26490,17.2,32.3,9833,5.7,64.6,0,5402,5411,22882
1992,60,c) 2,23644,25182,140849,149605,1312,4.8,4849,17.8,37876,7944,29932,5.3,25.3,54418,28816,25602,19.3,36.4,-16542,-11.1,50.6,0,3777,3789,22826
1992,60,d) 3,20876,22162,133608,134479,1227,5.2,3582,15.2,37551,6337,31214,4.7,27.9,38252,20468,17784,15.2,28.4,-701,-0.5,55.8,0,2765,2768,16262
1992,60,e) 4,18743,20142,124686,127066,1086,5.1,2929,13.8,30886,8746,22140,6.9,24.3,35229,15517,19712,12.2,27.7,-4343,-3.4,48.6,0,2194,2196,11134
1992,60,f) 5,18779,20222,120977,121913,1119,5.3,2477,11.8,28351,9145,19206,7.5,23.3,29420,11848,17572,9.7,24.1,-1069,-0.8,46.6,0,1853,1859,8550
1992,60,g) 6 to 10,67663,76770,543196,548810,5326,6.8,7583,9.7,113843,29435,84408,5.4,20.7,124458,45557,78901,8.3,22.7,-10615,-2,41.4,0,5307,5335,30497
1992,60,h) 11 to 15,48969,59201,507458,510946,4197,7,4712,7.9,105085,39013,66072,7.6,20.6,110149,34458,75691,6.7,21.6,-5064,-1,41.2,0,2868,2883,14972
1992,60,l) Left Censored,96203,251654,4892103,4965317,19487,7.7,19234,7.6,743858,261505,482353,5.3,15,889900,258589,631311,5.2,17.9,-146042,-2.9,30,0,4404,5141,52426
1992,70,a) 0,173433,176475,1158073,579037,175974,199.4,0,0,1148205,1148205,0,198.3,198.3,0,0,0,0,0,1148205,198.3,0,0,,,
1992,70,b) 1,136072,139357,1001249,982022,1720,1.1,32223,20.6,331114,36545,294569,3.7,33.7,282529,158439,124090,16.1,28.8,48585,4.9,57.6,0,24717,24723,128734
1992,70,c) 2,120665,124314,975388,1006252,5216,3.9,21809,16.3,227286,35007,192279,3.5,22.6,281989,150809,131180,15,28,-54703,-5.4,45.2,0,17128,17167,126087
1992,70,d) 3,104477,108365,958694,972854,4263,3.7,16198,14.1,201685,30900,170785,3.2,20.7,224940,107684,117256,11.1,23.1,-23255,-2.4,41.4,0,12797,12833,87809
1992,70,e) 4,93932,99082,1032372,1050929,3899,3.7,13495,12.9,199930,32306,167624,3.1,19,230449,105901,124548,10.1,21.9,-30519,-2.9,38,0,10266,10306,79897
1992,70,f) 5,89829,96697,1714143,1704898,3765,3.7,12048,11.9,300533,52596,247937,3.1,17.6,285343,103658,181685,6.1,16.7,15190,0.9,33.4,0,8569,8767,76593
1992,70,g) 6 to 10,371773,404281,4307254,4339213,15177,3.6,36858,8.9,694555,133428,561127,3.1,16,747584,281105,466479,6.5,17.2,-53029,-1.2,32,0,24994,25380,193075
1992,70,h) 11 to 15,242180,295908,4049297,4079121,11542,3.8,21852,7.2,606885,121936,484949,3,14.9,656319,217525,438794,5.3,16.1,-49434,-1.2,29.8,0,12506,12984,134423
1992,70,l) Left Censored,404121,548885,15074139,15042298,21259,3.8,36938,6.6,1818423,419770,1398653,2.8,12.1,1736317,496280,1240037,3.3,11.5,82106,0.6,23,0,17823,18316,135460
1993,07,a) 0,8868,8886,39309,19655,8766,197.3,0,0,39031,,,,198.6,0,0,0,0,0,39031,198.6,0,1,,,
1993,07,b) 1,7242,7253,39957,39790,1,0,1999,23.9,16409,,,,41.2,15393,6729,8664,16.9,38.7,1016,2.5,77.4,1,1337,1337,4549
1993,07,c) 2,6359,6369,53080,47218,223,3.3,1137,16.6,25301,1115,24186,2.4,53.6,13289,6257,7032,13.3,28.1,12012,25.5,56.2,0,819,819,3792
1993,07,d) 3,6607,6608,40296,41904,297,4.3,930,13.4,10786,1018,9768,2.4,25.7,13672,4696,8976,11.2,32.6,-2886,-6.9,51.4,0,627,627,3131
1993,07,e) 4,5443,5449,35820,35997,181,3.2,639,11.2,8699,579,8120,1.6,24.2,8884,2981,5903,8.3,24.7,-185,-0.5,48.4,0,452,452,2176
1993,07,f) 5,4727,4741,31566,32192,172,3.5,494,10.1,6717,582,6135,1.8,20.9,7882,2532,5350,7.9,24.5,-1165,-3.6,41.8,0,342,343,1930
1993,07,g) 6 to 10,16446,16531,130422,131573,513,3,1491,8.7,26201,3271,22930,2.5,19.9,27943,8341,19602,6.3,21.2,-1742,-1.3,39.8,0,1001,1001,6180
1993,07,h) 11 to 15,9692,9723,83644,85453,245,2.5,657,6.6,12268,1026,11242,1.2,14.4,15764,3834,11930,4.5,18.4,-3496,-4,28.8,0,430,430,2227
1993,07,i) 16 to 20,1616,1650,15716,15678,46,2.7,119,7.1,2641,193,2448,1.2,16.8,2782,748,2034,4.8,17.7,-141,-0.9,33.6,0,84,84,534
1993,07,l) Left Censored,10115,11164,153120,154967,299,2.6,772,6.8,27434,4843,22591,3.1,17.7,31469,8693,22776,5.6,20.3,-4035,-2.6,35.4,0,434,435,2008
1993,10,a) 0,1678,1690,12080,6040,1680,198.8,0,0,12065,,,,199.8,0,0,0,0,0,12065,199.8,0,1,,,
1993,10,b) 1,1297,1307,13441,13857,2,0.1,407,26.5,3958,,,,28.6,4589,2961,1628,21.4,33.1,-631,-4.5,57.2,1,327,327,2612
1993,10,c) 2,1290,1403,21738,23058,45,2.9,300,19.5,3976,270,3706,1.2,17.2,6578,2880,3698,12.5,28.5,-2602,-11.3,34.4,0,248,248,2405
1993,10,d) 3,1217,1228,12668,13339,50,3.8,199,15.2,2575,262,2313,2,19.3,3811,1849,1962,13.9,28.6,-1236,-9.3,38.6,0,165,165,1642
1993,10,e) 4,921,928,10473,11346,19,1.9,187,18.4,1414,54,1360,0.5,12.5,3185,1317,1868,11.6,28.1,-1771,-15.6,25,0,156,156,1155
1993,10,f) 5,856,862,7461,8052,20,2.1,154,16.6,937,59,878,0.7,11.6,2082,963,1119,12,25.9,-1145,-14.3,23.2,0,122,122,816
1993,10,g) 6 to 10,3915,4042,44865,46292,133,3.1,548,12.9,7606,1723,5883,3.7,16.4,10304,4297,6007,9.3,22.3,-2698,-5.9,32.8,0,430,434,3374
1993,10,h) 11 to 15,3394,3610,45873,47967,105,2.8,448,11.8,6313,672,5641,1.4,13.2,10436,4161,6275,8.7,21.8,-4123,-8.6,26.4,0,314,316,2962
1993,10,i) 16 to 20,482,554,7889,8099,9,1.6,50,8.7,1003,38,965,0.5,12.4,1608,300,1308,3.7,19.9,-605,-7.5,24.8,0,27,27,92
1993,10,l) Left Censored,4932,9494,374825,396894,592,6.1,945,9.8,49677,16329,33348,4.1,12.5,94456,32168,62288,8.1,23.8,-44779,-11.3,25,0,288,289,1730
1993,15,a) 0,61353,61354,258519,129260,60622,197.6,0,0,256642,256642,0,198.5,198.5,0,0,0,0,0,256642,198.5,0,0,,,
1993,15,b) 1,42138,42166,251966,248632,12,0,13876,27.8,96714,728,95986,0.3,38.9,85558,49559,35999,19.9,34.4,11156,4.5,68.8,0,10368,10368,40332
1993,15,c) 2,35703,35765,214779,226390,1618,4.1,7765,19.9,62675,5994,56681,2.6,27.7,84081,39817,44264,17.6,37.1,-21406,-9.4,55.4,0,5998,5998,34254
1993,15,d) 3,35650,35681,221390,228525,1973,5.2,6794,17.8,60993,6332,54661,2.8,26.7,73857,31593,42264,13.8,32.3,-12864,-5.6,53.4,0,5045,5045,25458
1993,15,e) 4,31113,31149,201929,208032,1646,5,5241,15.9,52553,5846,46707,2.8,25.3,63733,24777,38956,11.9,30.6,-11180,-5.3,50.6,0,3873,3873,19698
1993,15,f) 5,28057,28107,187361,194128,1449,4.9,4415,14.9,44592,4530,40062,2.3,23,57737,20158,37579,10.4,29.7,-13145,-6.7,46,0,3222,3222,15669
1993,15,g) 6 to 10,102691,102934,835544,855629,4925,4.6,12619,11.8,178178,16215,161963,1.9,20.8,215846,61239,154607,7.2,25.2,-37668,-4.4,41.6,0,9065,9067,47628
1993,15,h) 11 to 15,64170,64702,631025,643796,2908,4.4,6549,9.8,120146,11470,108676,1.8,18.7,144387,36144,108243,5.6,22.4,-24241,-3.7,37.4,0,4486,4491,24689
1993,15,i) 16 to 20,12164,12314,116546,118389,592,4.7,1242,9.8,21619,2300,19319,1.9,18.3,25696,6398,19298,5.4,21.7,-4077,-3.4,36.6,0,849,853,4055
1993,15,l) Left Censored,83475,88172,1567318,1617556,2544,2.8,7661,8.4,247971,19323,228648,1.2,15.3,348123,56258,291865,3.5,21.5,-100152,-6.2,30.6,0,5411,5419,28250
1993,20,a) 0,26053,26073,225444,112722,25881,198.5,0,0,224773,224773,0,199.4,199.4,0,0,0,0,0,224773,199.4,0,0,,,
1993,20,b) 1,19163,19280,230944,219820,152,0.7,4926,22.5,81197,15246,65951,6.9,36.9,57291,33915,23376,15.4,26.1,23906,10.8,52.2,0,4104,4104,28865
1993,20,c) 2,17049,17258,213023,226514,534,2.9,3313,17.7,48440,6154,42286,2.7,21.4,73811,44570,29241,19.7,32.6,-25371,-11.2,42.8,0,2815,2815,39744
1993,20,d) 3,16337,16467,220360,221779,548,3.1,2561,14.6,46585,4667,41918,2.1,21,48867,23606,25261,10.6,22,-2282,-1,42,0,2131,2133,19549
1993,20,e) 4,15047,15246,230318,232272,427,2.7,1991,12.4,41964,4838,37126,2.1,18.1,45684,18885,26799,8.1,19.7,-3720,-1.6,36.2,0,1641,1641,15211
1993,20,f) 5,13670,13990,270440,270000,366,2.5,1668,11.4,43809,4020,39789,1.5,16.2,42638,17406,25232,6.4,15.8,1171,0.4,31.6,0,1400,1400,13527
1993,20,g) 6 to 10,54835,56719,1315809,1322823,1426,2.4,5228,8.9,178529,21877,156652,1.7,13.5,191644,59645,131999,4.5,14.5,-13115,-1,27,0,4180,4194,41675
1993,20,h) 11 to 15,40182,43162,1296355,1298322,975,2.2,3038,6.9,154184,20663,133521,1.6,11.9,157466,42522,114944,3.3,12.1,-3282,-0.2,23.8,0,2283,2295,23871
1993,20,i) 16 to 20,7667,8992,346994,344806,229,2.5,595,6.5,42653,7751,34902,2.2,12.4,40155,10593,29562,3.1,11.6,2498,0.8,23.2,0,382,389,3833
1993,20,l) Left Censored,87231,138147,13668102,13779662,3092,2.2,7902,5.6,1133676,184509,949167,1.3,8.2,1385228,332300,1052928,2.4,10.1,-251552,-1.9,16.4,0,3621,3697,54043
1993,40,a) 0,22136,22188,112502,56251,21988,198.2,0,0,111355,111355,0,198,198,0,0,0,0,0,111355,198,0,0,,,
1993,40,b) 1,15532,16556,123089,118651,52,0.3,4613,24.2,42673,6142,36531,5.2,36,32107,18830,13277,15.9,27.1,10566,8.9,54.2,0,3800,3800,15625
1993,40,c) 2,12987,13542,109532,111761,475,3.2,2608,17.8,27366,3886,23480,3.5,24.5,31429,16051,15378,14.4,28.1,-4063,-3.6,49,0,2159,2169,14038
1993,40,d) 3,11685,12219,102779,104654,444,3.4,2003,15.4,21522,3227,18295,3.1,20.6,24667,11317,13350,10.8,23.6,-3145,-3,41.2,0,1638,1646,9578
1993,40,e) 4,10177,10696,104002,104637,380,3.4,1615,14.3,22608,2464,20144,2.4,21.6,23569,9847,13722,9.4,22.5,-961,-0.9,43.2,0,1314,1314,7793
1993,40,f) 5,8867,9610,96573,97149,366,3.6,1297,12.9,18894,2732,16162,2.8,19.4,19921,8665,11256,8.9,20.5,-1027,-1.1,38.8,0,1003,1017,5891
1993,40,g) 6 to 10,32063,38286,561802,569090,1384,3.5,4156,10.5,83297,11153,72144,2,14.6,96921,33286,63635,5.8,17,-13624,-2.4,29.2,0,2926,2941,19953
1993,40,h) 11 to 15,19071,28090,567876,571291,1273,4.5,2129,7.5,68373,14031,54342,2.5,12,83763,20211,63552,3.5,14.7,-15390,-2.7,24,0,1372,1399,12291
1993,40,i) 16 to 20,3543,7440,218268,214939,518,6.9,570,7.6,37146,11865,25281,5.5,17.3,30840,5487,25353,2.6,14.3,6306,3,28.6,0,200,202,1408
1993,40,l) Left Censored,30342,80387,3574098,3584750,4791,5.9,7263,8.9,409228,93867,315361,2.6,11.4,429962,134215,295747,3.7,12,-20734,-0.6,22.8,0,1447,1562,15750
1993,50,a) 0,33036,33133,142842,71421,32929,198.8,0,0,141777,141777,0,198.5,198.5,0,0,0,0,0,141777,198.5,0,0,,,
1993,50,b) 1,26158,26822,152730,148515,131,0.4,6391,21.1,46830,3968,42862,2.7,31.5,37018,21168,15850,14.3,24.9,9812,6.6,49.8,0,5221,5221,17958
1993,50,c) 2,22972,23667,149509,158909,755,3,4115,16.2,33602,3267,30335,2.1,21.1,51829,23858,27971,15,32.6,-18227,-11.5,42.2,0,3407,3409,17597
1993,50,d) 3,21075,21625,146243,147596,642,2.8,3083,13.5,29014,2713,26301,1.8,19.7,31365,14291,17074,9.7,21.3,-2351,-1.6,39.4,0,2566,2566,12069
1993,50,e) 4,18741,19382,142108,143610,533,2.6,2464,12.1,25181,2234,22947,1.6,17.5,27965,12289,15676,8.6,19.5,-2784,-2,35,0,2049,2060,10375
1993,50,f) 5,16768,17907,149029,149488,574,3.1,1977,10.6,27301,3281,24020,2.2,18.3,28079,10254,17825,6.9,18.8,-778,-0.5,36.6,0,1577,1577,8383
1993,50,g) 6 to 10,69162,76745,754476,760883,2019,2.5,6905,8.7,110256,14246,96010,1.9,14.5,124285,42063,82222,5.5,16.3,-14029,-1.8,29,0,5046,5096,29945
1993,50,h) 11 to 15,47667,54996,627355,635618,1263,2.2,3963,7,76593,9724,66869,1.5,12.1,92355,30197,62158,4.8,14.5,-15762,-2.4,24.2,0,2639,2695,19174
1993,50,i) 16 to 20,9869,14916,219930,218773,490,3.2,945,6.2,31191,6527,24664,3,14.3,29418,8439,20979,3.9,13.4,1773,0.9,26.8,0,432,463,3376
1993,50,l) Left Censored,91006,178146,3684673,3723554,6595,3.6,12479,6.9,441353,102258,339095,2.7,11.9,516161,154105,362056,4.1,13.9,-74808,-2,23.8,0,3956,4196,33888
1993,52,a) 0,111108,112190,740554,370277,111428,198.6,0,0,737202,737202,0,199.1,199.1,0,0,0,0,0,737202,199.1,0,0,,,
1993,52,b) 1,83117,86982,690752,729379,648,0.6,25663,25.6,160163,12306,147857,1.7,22,231851,132358,99493,18.1,31.8,-71688,-9.8,44,0,21902,21921,115825
1993,52,c) 2,70974,74963,622447,653189,2672,3.3,15779,19.3,118148,17229,100919,2.6,18.1,178710,94800,83910,14.5,27.4,-60562,-9.3,36.2,0,13315,13355,80029
1993,52,d) 3,63164,67158,569064,593832,2295,3.2,12315,17,96480,15720,80760,2.6,16.2,145180,72574,72606,12.2,24.4,-48700,-8.2,32.4,0,10389,10424,61722
1993,52,e) 4,55548,61375,551121,569457,2255,3.5,9673,14.9,91003,20948,70055,3.7,16,126890,60229,66661,10.6,22.3,-35887,-6.3,32,0,7887,7921,47851
1993,52,f) 5,48821,54434,514395,529568,1690,2.9,8105,14.1,83805,15644,68161,3,15.8,114284,51254,63030,9.7,21.6,-30479,-5.8,31.6,0,6484,6511,39595
1993,52,g) 6 to 10,186211,219097,2328084,2376864,7579,3.3,25572,11.2,334662,73233,261429,3.1,14.1,430684,171250,259434,7.2,18.1,-96022,-4,28.2,0,18451,18809,115994
1993,52,h) 11 to 15,117947,153006,1859000,1881144,4751,3,14293,9.1,243789,57395,186394,3.1,13,286981,104236,182745,5.5,15.3,-43192,-2.3,26,0,9055,9422,60563
1993,52,i) 16 to 20,25353,48574,683247,683938,1729,3.5,3798,7.7,92772,22905,69867,3.3,13.6,95328,29557,65771,4.3,13.9,-2556,-0.3,27.2,0,1623,1859,10569
1993,52,l) Left Censored,179959,513676,11291842,11207227,23033,4.4,44478,8.5,1632127,500963,1131164,4.5,14.6,1473831,496846,976985,4.4,13.2,158296,1.4,26.4,0,12117,12838,88176
1993,60,a) 0,36715,36876,142971,71486,36506,198,0,0,141641,141641,0,198.1,198.1,0,0,0,0,0,141641,198.1,0,0,,,
1993,60,b) 1,26529,27459,143287,141088,205,0.7,6801,21.8,44601,7814,36787,5.5,31.6,38698,23169,15529,16.4,27.4,5903,4.2,54.8,0,5345,5346,18797
1993,60,c) 2,23004,25170,152955,157814,853,3.2,4129,15.3,31396,3982,27414,2.5,19.9,39904,21438,18466,13.6,25.3,-8508,-5.4,39.8,0,3216,3235,16713
1993,60,d) 3,20932,22321,128586,130677,807,3.4,3242,13.7,27213,3328,23885,2.5,20.8,31184,13165,18019,10.1,23.9,-3971,-3.1,41.6,0,2462,2492,9335
1993,60,e) 4,18825,20120,127416,128862,703,3.3,2539,12,24523,3894,20629,3,19,27634,10225,17409,7.9,21.4,-3111,-2.4,38,0,1942,1948,7729
1993,60,f) 5,17243,18553,113315,116402,712,3.7,2167,11.2,18912,2561,16351,2.2,16.2,24947,8363,16584,7.2,21.4,-6035,-5.2,32.4,0,1572,1606,5690
1993,60,g) 6 to 10,71034,80133,554916,561365,2828,3.4,7434,9,90252,14580,75672,2.6,16.1,102660,34792,67868,6.2,18.3,-12408,-2.2,32.2,0,5229,5276,21276
1993,60,h) 11 to 15,47174,54587,433901,441530,1803,3.2,4231,7.6,61325,13080,48245,3,13.9,76164,23566,52598,5.3,17.3,-14839,-3.4,27.8,0,2728,2799,11992
1993,60,i) 16 to 20,9491,14123,162222,162080,493,3.4,967,6.7,21683,2705,18978,1.7,13.4,21644,8870,12774,5.5,13.4,39,0,26.8,0,487,493,2115
1993,60,l) Left Censored,91494,241663,4741055,4795990,13874,5.6,22398,9.1,744058,255511,488547,5.3,15.5,853761,347438,506323,7.2,17.8,-109703,-2.3,31,0,3931,4527,34360
1993,70,a) 0,174537,175279,977132,488566,173991,198.5,0,0,972216,972216,0,199,199,0,0,0,0,0,972216,199,0,0,,,
1993,70,b) 1,135684,139185,1277292,1225497,661,0.4,34439,21.8,431990,70497,361493,5.8,35.3,319347,145677,173670,11.9,26.1,112643,9.2,52.2,0,27485,27495,119430
1993,70,c) 2,118336,121906,936319,963969,4057,3.1,20633,15.8,222978,26630,196348,2.8,23.1,275022,134136,140886,13.9,28.5,-52044,-5.4,46.2,0,16411,16465,106736
1993,70,d) 3,107866,111448,961135,965638,3784,3.2,15853,13.5,207576,25482,182094,2.6,21.5,214569,93982,120587,9.7,22.2,-6993,-0.7,43,0,12540,12552,74299
1993,70,e) 4,94719,98698,934206,944574,3046,2.9,12395,12,170495,20646,149849,2.2,18,190134,81758,108376,8.7,20.1,-19639,-2.1,36,0,9833,9855,67171
1993,70,f) 5,86194,91064,1005744,1016011,2884,3,10551,11.1,163790,33112,130678,3.3,16.1,183157,77993,105164,7.7,18,-19367,-1.9,32.2,0,8011,8075,59993
1993,70,g) 6 to 10,380576,414072,5182688,5220041,12337,2.9,34534,8.1,691525,107507,584018,2.1,13.2,762253,246815,515438,4.7,14.6,-70728,-1.4,26.4,0,24692,24871,163547
1993,70,h) 11 to 15,241102,275611,3430033,3431643,7847,2.8,18677,6.6,480790,73439,407351,2.1,14,484133,131319,352814,3.8,14.1,-3343,-0.1,28,0,12298,12400,74842
1993,70,i) 16 to 20,45585,71628,1395096,1380680,2416,3.3,4470,6.2,202960,48939,154021,3.5,14.7,178139,48143,129996,3.5,12.9,24821,1.8,25.8,0,1938,1993,12432
1993,70,l) Left Censored,387288,531447,15230118,15170237,15955,3,32767,6.1,1786956,351602,1435354,2.3,11.8,1663611,435176,1228435,2.9,11,123345,0.8,22,0,16578,16755,102837
1994,07,a) 0,9668,9680,37007,18504,9587,198.1,0,0,36579,,,,197.7,0,0,0,0,0,36579,197.7,0,1,,,
1994,07,b) 1,6879,6908,44514,42579,11,0.1,1779,22.5,18762,,,,44.1,13821,6133,7688,14.4,32.5,4941,11.6,65,1,1245,1245,3635
1994,07,c) 2,6297,6310,42281,40233,225,3.3,1052,15.6,18623,1190,17433,3,46.3,14346,4817,9529,12,35.7,4277,10.6,71.4,0,726,726,3191
1994,07,d) 3,5684,5694,32570,42607,226,3.8,845,14,7227,1399,5828,3.3,17,27243,3449,23794,8.1,63.9,-20016,-46.9,34,0,624,624,2464
1994,07,e) 4,5974,5975,34158,37594,206,3.3,799,12.7,7158,832,6326,2.2,19,13767,3813,9954,10.1,36.6,-6609,-17.6,38,0,537,537,2555
1994,07,f) 5,4998,5005,30940,33207,159,3,583,11.2,5511,448,5063,1.3,16.6,10092,3174,6918,9.6,30.4,-4581,-13.8,33.2,0,431,431,2285
1994,07,g) 6 to 10,17719,17805,127967,134927,541,2.9,1643,8.9,22623,2183,20440,1.6,16.8,36262,10848,25414,8,26.9,-13639,-10.1,33.6,0,1130,1130,5816
1994,07,h) 11 to 15,9829,9863,83266,85576,236,2.3,698,6.9,11657,978,10679,1.1,13.6,16178,3401,12777,4,18.9,-4521,-5.3,27.2,0,474,474,2333
1994,07,i) 16 to 20,3137,3178,27663,28703,67,2.1,195,6,3595,185,3410,0.6,12.5,5640,979,4661,3.4,19.6,-2045,-7.1,25,0,122,122,699
1994,07,l) Left Censored,9671,10748,143234,147229,396,3.6,714,6.5,27584,7638,19946,5.2,18.7,35183,9785,25398,6.6,23.9,-7599,-5.2,37.4,0,424,424,1973
1994,10,a) 0,1588,1588,13612,6806,1581,199.1,0,0,13598,13598,0,199.8,199.8,0,0,0,0,0,13598,199.8,0,0,,,
1994,10,b) 1,1272,1284,12642,12332,7,0.5,371,25,4376,544,3832,4.4,35.5,3631,2112,1519,17.1,29.4,745,6.1,58.8,0,305,305,1877
1994,10,c) 2,1066,1077,12973,13147,31,2.6,254,21.3,3447,298,3149,2.3,26.2,3752,2276,1476,17.3,28.5,-305,-2.3,52.4,0,209,209,2077
1994,10,d) 3,1132,1219,18684,19972,48,3.7,220,16.8,3084,528,2556,2.6,15.4,5922,2973,2949,14.9,29.7,-2838,-14.3,30.8,0,143,143,1386
1994,10,e) 4,1074,1086,11063,11925,37,3.2,179,15.5,1888,435,1453,3.6,15.8,3550,1115,2435,9.4,29.8,-1662,-14,31.6,0,132,132,801
1994,10,f) 5,816,823,9209,9841,19,2.2,121,13.8,1486,221,1265,2.2,15.1,2731,1099,1632,11.2,27.8,-1245,-12.7,30.2,0,97,97,667
1994,10,g) 6 to 10,3654,3762,40230,41206,113,2.8,524,13.2,6483,950,5533,2.3,15.7,8447,3385,5062,8.2,20.5,-1964,-4.8,31.4,0,414,415,2556
1994,10,h) 11 to 15,3354,3564,43906,45148,139,3.8,345,9.4,6587,1551,5036,3.4,14.6,9101,3869,5232,8.6,20.2,-2514,-5.6,29.2,0,250,252,2172
1994,10,i) 16 to 20,934,1032,15957,15905,34,3.2,111,10.4,2534,390,2144,2.5,15.9,2588,988,1600,6.2,16.3,-54,-0.4,31.8,0,76,76,421
1994,10,l) Left Censored,4631,9201,368850,372931,439,4.7,795,8.5,44159,12532,31627,3.4,11.8,53208,14034,39174,3.8,14.3,-9049,-2.5,23.6,0,274,279,1934
1994,15,a) 0,66285,66301,283892,141946,65566,197.8,0,0,281909,281909,0,198.6,198.6,0,0,0,0,0,281909,198.6,0,0,,,
1994,15,b) 1,45365,45371,254057,256074,29,0.1,14275,26.8,90002,1609,88393,0.6,35.1,89116,51217,37899,20,34.8,886,0.3,69.6,0,10739,10739,41522
1994,15,c) 2,35426,35450,222726,237231,1485,3.8,7698,19.8,62616,5381,57235,2.3,26.4,90033,38811,51222,16.4,38,-27417,-11.6,52.8,0,5901,5903,31863
1994,15,d) 3,31348,31430,203569,209163,1486,4.4,5572,16.6,57124,4668,52456,2.2,27.3,66804,26887,39917,12.9,31.9,-9680,-4.6,54.6,0,4150,4150,21915
1994,15,e) 4,31959,31990,210734,215586,1665,4.9,5178,15.3,55319,5191,50128,2.4,25.7,63945,24556,39389,11.4,29.7,-8626,-4,51.4,0,3799,3799,19468
1994,15,f) 5,28227,28258,191334,196700,1353,4.6,4135,13.9,46411,4286,42125,2.2,23.6,56328,20572,35756,10.5,28.6,-9917,-5,47.2,0,3053,3054,15578
1994,15,g) 6 to 10,110048,110301,880773,892544,5268,4.6,13131,11.5,194400,17318,177082,1.9,21.8,215592,63082,152510,7.1,24.2,-21192,-2.4,43.6,0,9436,9436,47782
1994,15,h) 11 to 15,59960,60484,621489,624871,2532,4.1,5703,9.2,121586,9865,111721,1.6,19.5,127004,30323,96681,4.9,20.3,-5418,-0.8,39,0,3971,3971,21983
1994,15,i) 16 to 20,24042,24278,235285,236295,1061,4.3,2336,9.4,44227,4695,39532,2,18.7,45948,11526,34422,4.9,19.4,-1721,-0.7,37.4,0,1606,1606,7927
1994,15,l) Left Censored,78811,83599,1560918,1564711,2437,2.8,6788,7.9,260898,26538,234360,1.7,16.7,266511,51013,215498,3.3,17,-5613,-0.3,33.4,0,4817,4821,26949
1994,20,a) 0,26633,26662,236582,118291,26500,198.8,0,0,235952,235952,0,199.5,199.5,0,0,0,0,0,235952,199.5,0,0,,,
1994,20,b) 1,20322,20382,227009,224649,112,0.5,5293,22.8,71092,10617,60475,4.7,31.6,64737,41343,23394,18.4,28.8,6355,2.8,57.6,0,4349,4349,35687
1994,20,c) 2,16155,16299,201629,215399,398,2.2,3206,18,43173,3084,40089,1.4,20,70091,40810,29281,18.9,32.5,-26918,-12.5,40,0,2746,2748,36558
1994,20,d) 3,15037,15260,207994,210585,403,2.5,2327,14.3,40716,3262,37454,1.5,19.3,45697,22667,23030,10.8,21.7,-4981,-2.4,38.6,0,1940,1941,18746
1994,20,e) 4,14622,14764,212915,216043,425,2.7,2057,13.2,39866,3912,35954,1.8,18.5,45626,22640,22986,10.5,21.1,-5760,-2.6,37,0,1658,1665,17144
1994,20,f) 5,13734,13964,223669,224888,370,2.5,1593,10.9,37437,4035,33402,1.8,16.6,39569,16742,22827,7.4,17.6,-2132,-1,33.2,0,1321,1324,14050
1994,20,g) 6 to 10,55963,57764,1349827,1349485,1278,2.1,5459,9.1,188748,20891,167857,1.5,14,186927,68894,118033,5.1,13.9,1821,0.1,27.8,0,4298,4313,49427
1994,20,h) 11 to 15,38736,41884,1296900,1296468,912,2.1,2975,6.9,155318,19822,135496,1.5,12,153548,46500,107048,3.6,11.8,1770,0.2,23.6,0,2182,2188,27358
1994,20,i) 16 to 20,14134,16062,587947,584198,407,2.5,1066,6.5,68264,10851,57413,1.9,11.7,60525,18602,41923,3.2,10.4,7739,1.3,20.8,0,730,740,8533
1994,20,l) Left Censored,83391,134414,13475202,13580282,3371,2.5,7159,5.2,1104835,218620,886215,1.6,8.1,1318132,331409,986723,2.4,9.7,-213297,-1.6,16.2,0,3382,3450,53864
1994,40,a) 0,23990,24138,122028,61014,23964,198.6,0,0,121498,121498,0,199.1,199.1,0,0,0,0,0,121498,199.1,0,0,,,
1994,40,b) 1,16919,17012,115784,114053,66,0.3,4799,24.5,37184,1455,35729,1.3,32.6,32562,19963,12599,17.5,28.5,4622,4.1,57,0,3978,3978,16266
1994,40,c) 2,12888,13881,109355,116131,494,3.2,3009,19.8,26679,3188,23491,2.7,23,39783,20073,19710,17.3,34.3,-13104,-11.3,46,0,2389,2391,15793
1994,40,d) 3,11264,11896,106777,108015,455,3.6,2021,15.9,23732,3044,20688,2.8,22,25566,11994,13572,11.1,23.7,-1834,-1.7,44,0,1634,1634,9337
1994,40,e) 4,10362,10923,98915,100838,387,3.3,1650,14.3,19239,2145,17094,2.1,19.1,22731,12015,10716,11.9,22.5,-3492,-3.4,38.2,0,1313,1314,8189
1994,40,f) 5,9205,9739,97906,100478,355,3.5,1297,12.7,17893,2288,15605,2.3,17.8,22876,7649,15227,7.6,22.8,-4983,-5,35.6,0,1031,1034,5855
1994,40,g) 6 to 10,33724,38409,480508,483871,1498,3.8,4144,10.4,77385,11817,65568,2.4,16,83855,31283,52572,6.5,17.3,-6470,-1.3,32,0,3048,3077,21738
1994,40,h) 11 to 15,18820,29970,678260,686845,1243,4.1,2512,8.2,79507,17402,62105,2.5,11.6,96797,21632,75165,3.1,14.1,-17290,-2.5,23.2,0,1307,1315,8736
1994,40,i) 16 to 20,6365,10855,258057,263559,710,6.5,836,7.7,27369,7643,19726,2.9,10.4,38335,8740,29595,3.3,14.5,-10966,-4.1,20.8,0,430,444,4255
1994,40,l) Left Censored,28862,80175,3606270,3587354,5624,7,5896,7.3,415738,123438,292300,3.4,11.6,378267,118303,259964,3.3,10.5,37471,1.1,21,0,1422,1541,17098
1994,50,a) 0,34096,34286,152114,76057,34088,198.8,0,0,151587,151587,0,199.3,199.3,0,0,0,0,0,151587,199.3,0,0,,,
1994,50,b) 1,26114,26291,142797,142873,140,0.5,6429,21.6,44824,4094,40730,2.9,31.4,43160,25010,18150,17.5,30.2,1664,1.2,60.4,0,5213,5213,19603
1994,50,c) 2,22334,22909,141604,146818,601,2.4,4299,17.3,31176,2417,28759,1.6,21.2,41035,21561,19474,14.7,27.9,-9859,-6.7,42.4,0,3462,3464,17874
1994,50,d) 3,20254,20976,143713,146529,580,2.6,3160,14.2,28653,2303,26350,1.6,19.6,33882,16774,17108,11.4,23.1,-5229,-3.5,39.2,0,2540,2541,13912
1994,50,e) 4,18922,19528,140650,142748,571,2.8,2539,12.4,25974,2880,23094,2,18.2,29583,12753,16830,8.9,20.7,-3609,-2.5,36.4,0,2048,2053,10162
1994,50,f) 5,17035,17715,137391,139813,452,2.4,2103,11.3,22212,2082,20130,1.5,15.9,27109,10621,16488,7.6,19.4,-4897,-3.5,31.8,0,1712,1718,8711
1994,50,g) 6 to 10,69816,77033,763737,767913,2082,2.6,7159,9,113765,14478,99287,1.9,14.8,121437,47758,73679,6.2,15.8,-7672,-1,29.6,0,5228,5256,32895
1994,50,h) 11 to 15,47317,55147,637943,642435,1580,2.8,4032,7.1,80081,11986,68095,1.9,12.5,87929,31310,56619,4.9,13.7,-7848,-1.2,25,0,2562,2632,16252
1994,50,i) 16 to 20,17144,23740,339703,336167,879,3.6,1616,6.7,45883,10738,35145,3.2,13.6,38623,11675,26948,3.5,11.5,7260,2.1,23,0,797,807,4571
1994,50,l) Left Censored,86751,173788,3646081,3665218,6817,3.9,11052,6.3,430094,98344,331750,2.7,11.7,465999,144250,321749,3.9,12.7,-35905,-1,23.4,0,3643,3887,30373
1994,52,a) 0,113280,115135,805199,402600,114479,198.9,0,0,803132,803132,0,199.5,199.5,0,0,0,0,0,803132,199.5,0,0,,,
1994,52,b) 1,83943,85630,657604,698664,698,0.7,25645,25.9,152653,12919,139734,1.8,21.8,228432,133280,95152,19.1,32.7,-75779,-10.9,43.6,0,21783,21792,115993
1994,52,c) 2,68468,72806,604389,646733,2549,3.2,16153,20.2,110065,20818,89247,3.2,17,192394,97267,95127,15,29.7,-82329,-12.7,34,0,13538,13560,80548
1994,52,d) 3,60476,64402,560833,590491,2123,3,12268,17.6,96236,17767,78469,3,16.3,154435,82003,72432,13.9,26.2,-58199,-9.9,32.6,0,10035,10057,67465
1994,52,e) 4,55051,59072,521043,544443,1911,3,9771,15.5,81946,16381,65565,3,15.1,127396,61056,66340,11.2,23.4,-45450,-8.3,30.2,0,7784,7818,47529
1994,52,f) 5,48741,55028,526712,539843,2109,3.6,8327,14.3,87458,22854,64604,4.2,16.2,113083,49708,63375,9.2,20.9,-25625,-4.7,32.4,0,6675,6695,38386
1994,52,g) 6 to 10,187953,222188,2366320,2423101,8470,3.7,26774,11.6,342155,98522,243633,4.1,14.1,453377,176591,276786,7.3,18.7,-111222,-4.6,28.2,0,19672,19928,121435
1994,52,h) 11 to 15,114604,148431,1823728,1843256,5250,3.4,14163,9.3,245254,74147,171107,4,13.3,282417,101115,181302,5.5,15.3,-37163,-2,26.6,0,9281,9445,59939
1994,52,i) 16 to 20,43386,73069,1032690,1034044,2861,3.8,6179,8.3,137968,45426,92542,4.4,13.3,140490,49686,90804,4.8,13.6,-2522,-0.3,26.6,0,3013,3235,22182
1994,52,l) Left Censored,167762,502981,11272943,11284126,26251,5.2,36635,7.2,1469384,574579,894805,5.1,13,1492927,448761,1044166,4,13.2,-23543,-0.2,26,0,11362,11789,76574
1994,60,a) 0,39254,39582,166213,83107,39289,198.5,0,0,165300,165300,0,198.9,198.9,0,0,0,0,0,165300,198.9,0,0,,,
1994,60,b) 1,28950,29298,172942,159414,203,0.6,6915,20.9,69826,4126,65700,2.6,43.8,40840,23437,17403,14.7,25.6,28986,18.2,51.2,0,5354,5354,18805
1994,60,c) 2,22889,23909,134481,138208,762,3,4045,15.8,30053,3270,26783,2.4,21.7,37109,17577,19532,12.7,26.9,-7056,-5.2,43.4,0,3184,3190,14108
1994,60,d) 3,20415,22514,141368,143368,756,3.2,3124,13.1,26293,4201,22092,2.9,18.3,30010,14553,15457,10.2,20.9,-3717,-2.6,36.6,0,2341,2343,10142
1994,60,e) 4,18970,20537,127490,128030,831,3.9,2564,12,25110,3782,21328,3,19.6,25897,10794,15103,8.4,20.2,-787,-0.6,39.2,0,1869,1881,7196
1994,60,f) 5,17298,18618,123498,124212,700,3.6,2128,11,21936,3594,18342,2.9,17.7,22940,9982,12958,8,18.5,-1004,-0.8,35.4,0,1637,1638,6601
1994,60,g) 6 to 10,72936,80780,555927,560322,2917,3.5,7368,8.9,88046,14933,73113,2.7,15.7,96571,37021,59550,6.6,17.2,-8525,-1.5,31.4,0,5190,5225,22426
1994,60,h) 11 to 15,46494,53985,422897,423893,1935,3.5,4574,8.3,60505,14468,46037,3.4,14.3,62390,22183,40207,5.2,14.7,-1885,-0.4,28.6,0,2578,2593,12728
1994,60,i) 16 to 20,17590,24166,255121,255470,1032,4.2,1621,6.6,33793,7688,26105,3,13.2,34243,10489,23754,4.1,13.4,-450,-0.2,26.4,0,849,884,3260
1994,60,l) Left Censored,87934,244023,4786080,4772435,20494,8.4,19279,7.9,771491,300816,470675,6.3,16.2,748066,267327,480739,5.6,15.7,23425,0.5,31.4,0,3509,3735,22232
1994,70,a) 0,182568,184010,1108963,554482,182750,198.6,0,0,1105245,,,,199.3,0,0,0,0,0,1105245,199.3,0,1,,,
1994,70,b) 1,137464,138991,1054815,1029582,701,0.4,33550,21.3,319336,,,,31,258780,146261,112519,14.2,25.1,60556,5.9,50.2,1,26537,26541,122320
1994,70,c) 2,116599,120225,1140924,1205433,3607,2.8,21305,16.4,226196,28068,198128,2.3,18.8,351531,164937,186594,13.7,29.2,-125335,-10.4,37.6,0,16829,16844,133192
1994,70,d) 3,105082,108751,889611,912101,3418,3,15779,13.7,179703,21188,158515,2.3,19.7,223139,103319,119820,11.3,24.5,-43436,-4.8,39.4,0,12279,12294,82033
1994,70,e) 4,97438,101113,916345,937873,3199,3,13066,12.3,167193,19838,147355,2.1,17.8,208681,92867,115814,9.9,22.3,-41488,-4.5,35.6,0,10044,10113,76479
1994,70,f) 5,86209,90265,890897,908785,2894,3.1,10920,11.6,150953,21284,129669,2.3,16.6,186942,72586,114356,8,20.6,-35989,-4,33.2,0,8333,8367,53887
1994,70,g) 6 to 10,383131,415743,5354700,5392954,12537,2.9,36948,8.6,702877,116258,586619,2.2,13,768822,283261,485561,5.3,14.3,-65945,-1.3,26,0,25992,26138,192118
1994,70,h) 11 to 15,242785,275298,3521954,3533584,8168,2.9,19701,7,458667,84857,373810,2.4,13,477354,146081,331273,4.1,13.5,-18687,-0.5,26,0,12724,12856,80844
1994,70,i) 16 to 20,83937,118337,1991090,1977773,4455,3.7,7657,6.4,265782,48923,216859,2.5,13.4,235988,60967,175021,3.1,11.9,29794,1.5,23.8,0,3826,3913,26630
1994,70,l) Left Censored,370214,518892,15305479,15273225,17544,3.3,31104,5.9,1681335,355370,1325965,2.3,11,1605405,426871,1178534,2.8,10.5,75930,0.5,21,0,16075,16363,110713
1995,07,a) 0,10745,10749,39920,19960,10648,198.1,0,0,39559,39559,0,198.2,198.2,0,0,0,0,0,39559,198.2,0,0,,,
1995,07,b) 1,7466,7506,37674,37812,30,0.3,1997,23.2,12227,937,11290,2.5,32.3,11964,5913,6051,15.6,31.6,263,0.7,63.2,0,1398,1398,3869
1995,07,c) 2,5909,5948,34609,34485,207,3.2,990,15.5,9307,1205,8102,3.5,27,8867,3839,5028,11.1,25.7,440,1.3,51.4,0,704,704,2807
1995,07,d) 3,5613,5626,30797,35826,210,3.5,806,13.6,7351,700,6651,2,20.5,17311,3228,14083,9,48.3,-9960,-27.8,41,0,570,570,2359
1995,07,e) 4,5185,5195,32292,32048,184,3.4,633,11.7,7645,930,6715,2.9,23.9,7135,2838,4297,8.9,22.3,510,1.6,44.6,0,459,459,2055
1995,07,f) 5,5480,5481,33264,33633,242,4.3,638,11.2,6934,906,6028,2.7,20.6,7665,3052,4613,9.1,22.8,-731,-2.2,41.2,0,422,422,1878
1995,07,g) 6 to 10,18884,18970,135370,135607,660,3.4,1705,8.7,23409,1925,21484,1.4,17.3,23853,7226,16627,5.3,17.6,-444,-0.3,34.6,0,1199,1199,5244
1995,07,h) 11 to 15,10303,10345,90646,90309,270,2.6,646,6.1,13555,1316,12239,1.5,15,12856,3029,9827,3.4,14.2,699,0.8,28.4,0,463,463,2097
1995,07,i) 16 to 20,4808,4850,42882,42384,127,2.6,263,5.3,6313,591,5722,1.4,14.9,5275,1412,3863,3.3,12.4,1038,2.5,24.8,0,183,183,1069
1995,07,l) Left Censored,9279,10375,150030,147242,361,3.4,650,6.2,26810,5124,21686,3.5,18.2,20930,5487,15443,3.7,14.2,5880,4,28.4,0,423,423,2267
1995,10,a) 0,1581,1583,14419,7210,1570,198.4,0,0,14381,14381,0,199.5,199.5,0,0,0,0,0,14381,199.5,0,0,,,
1995,10,b) 1,1196,1343,17947,16794,12,0.8,366,23.8,5996,2096,3900,12.5,35.7,3629,2194,1435,13.1,21.6,2367,14.1,43.2,0,288,288,1769
1995,10,c) 2,1050,1062,11723,12168,22,1.9,219,18.8,3351,142,3209,1.2,27.5,4232,2597,1635,21.3,34.8,-881,-7.3,55,0,182,182,2413
1995,10,d) 3,907,918,10035,11555,32,3.2,171,17.2,1328,198,1130,1.7,11.5,4349,2790,1559,24.1,37.6,-3021,-26.1,23,0,132,132,2289
1995,10,e) 4,988,1073,17987,18325,32,2.8,159,14,4005,894,3111,4.9,21.9,4509,1721,2788,9.4,24.6,-504,-2.7,43.8,0,121,121,680
1995,10,f) 5,895,915,14223,13128,37,3.8,149,15.2,4284,287,3997,2.2,32.6,2021,960,1061,7.3,15.4,2263,17.2,30.8,0,130,130,852
1995,10,g) 6 to 10,3438,3529,39712,41362,107,2.9,419,11.3,5284,696,4588,1.7,12.8,8448,3894,4554,9.4,20.4,-3164,-7.6,25.6,0,327,327,2844
1995,10,h) 11 to 15,3316,3509,42745,43348,115,3.2,335,9.2,6152,878,5274,2,14.2,7332,2273,5059,5.2,16.9,-1180,-2.7,28.4,0,246,246,1662
1995,10,i) 16 to 20,1283,1433,23333,23184,43,2.9,171,11.4,3539,658,2881,2.8,15.3,3204,1158,2046,5,13.8,335,1.5,27.6,0,118,119,459
1995,10,l) Left Censored,4316,8552,353571,359207,311,3.5,769,8.8,45878,7009,38869,2,12.8,57814,17334,40480,4.8,16.1,-11936,-3.3,25.6,0,242,254,1476
1995,15,a) 0,70882,70885,298539,149270,70172,198,0,0,296370,296370,0,198.5,198.5,0,0,0,0,0,296370,198.5,0,0,,,
1995,15,b) 1,49032,49096,284552,285591,20,0,15377,26.6,98607,595,98012,0.2,34.5,95760,55060,40700,19.3,33.5,2847,1,67,0,11830,11830,45435
1995,15,c) 2,38263,38270,243707,249073,1550,3.7,8098,19.4,69034,5609,63425,2.3,27.7,78155,38354,39801,15.4,31.4,-9121,-3.7,55.4,0,6274,6274,32372
1995,15,d) 3,31237,31266,218015,219775,1449,4.3,5298,15.9,56926,5679,51247,2.6,25.9,59470,25035,34435,11.4,27.1,-2544,-1.2,51.8,0,4110,4110,20741
1995,15,e) 4,28317,28476,201557,203968,1437,4.8,4227,14.1,49241,4697,44544,2.3,24.1,53723,19203,34520,9.4,26.3,-4482,-2.2,48.2,0,3192,3193,15408
1995,15,f) 5,29206,29233,209216,209930,1515,5,4087,13.4,50533,5022,45511,2.4,24.1,51434,19058,32376,9.1,24.5,-901,-0.4,48.2,0,2990,2990,14769
1995,15,g) 6 to 10,113211,113438,915649,910843,5443,4.6,12737,10.9,199384,18957,180427,2.1,21.9,187523,58732,128791,6.4,20.6,11861,1.3,41.2,0,9213,9213,46237
1995,15,h) 11 to 15,60926,61480,669901,664779,2602,4.1,5370,8.5,126285,10353,115932,1.6,19,114628,28248,86380,4.2,17.2,11657,1.8,34.4,0,3857,3858,20746
1995,15,i) 16 to 20,35559,35828,367850,366480,1604,4.4,3231,8.8,66499,5795,60704,1.6,18.1,62844,14927,47917,4.1,17.1,3655,1,34.2,0,2267,2268,10776
1995,15,l) Left Censored,74625,79365,1563973,1558693,2132,2.6,6140,7.5,240474,20937,219537,1.3,15.4,228198,45094,183104,2.9,14.6,12276,0.8,29.2,0,4364,4371,24050
1995,20,a) 0,26506,26528,235922,117961,26328,198.5,0,0,234918,234918,0,199.1,199.1,0,0,0,0,0,234918,199.1,0,0,,,
1995,20,b) 1,21049,21216,266146,253280,116,0.5,5150,21.5,88392,11959,76433,4.7,34.9,61101,38476,22625,15.2,24.1,27291,10.8,48.2,0,4294,4294,32648
1995,20,c) 2,17165,17243,213095,220244,490,2.6,3432,18.3,47727,4494,43233,2,21.7,59887,38155,21732,17.3,27.2,-12160,-5.5,43.4,0,2915,2915,34011
1995,20,d) 3,14244,14392,195560,197260,403,2.6,2207,14.4,38687,3483,35204,1.8,19.6,41780,21850,19930,11.1,21.2,-3093,-1.6,39.2,0,1868,1869,18918
1995,20,e) 4,13570,13896,216976,212949,384,2.6,1759,12,42427,4805,37622,2.3,19.9,33820,15740,18080,7.4,15.9,8607,4,31.8,0,1469,1469,13076
1995,20,f) 5,13323,13486,221490,216154,370,2.6,1568,11.1,43135,4032,39103,1.9,20,32528,15583,16945,7.2,15,10607,5,30,0,1278,1278,11936
1995,20,g) 6 to 10,56218,58000,1340995,1316539,1424,2.4,5178,8.6,205280,23193,182087,1.8,15.6,154530,54856,99674,4.2,11.7,50750,3.9,23.4,0,4150,4161,39685
1995,20,h) 11 to 15,38581,41832,1362638,1339473,983,2.3,2814,6.6,181151,26623,154528,2,13.5,133580,43218,90362,3.2,10,47571,3.5,20,0,2073,2082,26925
1995,20,i) 16 to 20,20586,23141,870598,856762,482,2,1437,6.1,105663,12593,93070,1.5,12.3,78594,25317,53277,3,9.2,27069,3.1,18.4,0,1015,1017,11658
1995,20,l) Left Censored,80039,131141,13610151,13546945,3378,2.5,6473,4.9,1191510,204902,986608,1.5,8.8,1066602,256432,810170,1.9,7.9,124908,0.9,15.8,0,3047,3082,40198
1995,40,a) 0,25969,26112,147690,73845,25949,198.8,0,0,147117,147117,0,199.2,199.2,0,0,0,0,0,147117,199.2,0,0,,,
1995,40,b) 1,18312,18619,129111,127524,108,0.5,5186,24.2,39713,1943,37770,1.5,31.1,35321,21078,14243,16.5,27.7,4392,3.4,55.4,0,4311,4311,18580
1995,40,c) 2,14128,14267,110088,112119,439,2.8,3025,19.4,27544,2900,24644,2.6,24.6,30918,17877,13041,15.9,27.6,-3374,-3,49.2,0,2554,2558,15288
1995,40,d) 3,11200,12195,107788,108160,397,3,1974,15.1,22836,2950,19886,2.7,21.1,23236,11151,12085,10.3,21.5,-400,-0.4,42.2,0,1585,1593,8900
1995,40,e) 4,10028,10734,111030,109232,403,3.6,1528,13.5,25691,4778,20913,4.4,23.5,21948,10860,11088,9.9,20.1,3743,3.4,40.2,0,1222,1226,8309
1995,40,f) 5,9345,9897,99206,98300,365,3.5,1326,12.8,22281,5057,17224,5.1,22.7,20584,8267,12317,8.4,20.9,1697,1.8,41.8,0,1007,1032,6071
1995,40,g) 6 to 10,34719,39289,503487,502867,1517,3.7,4398,10.8,89353,16038,73315,3.2,17.8,87546,37044,50502,7.4,17.4,1807,0.4,34.8,0,3185,3222,24199
1995,40,h) 11 to 15,19283,29565,698443,692458,1390,4.6,2353,7.8,95699,17586,78113,2.5,13.8,83853,18729,65124,2.7,12.1,11846,1.7,24.2,0,1245,1253,9893
1995,40,i) 16 to 20,9348,15731,342761,333706,962,6.1,1265,8,54675,15132,39543,4.5,16.4,36418,14841,21577,4.4,10.9,18257,5.5,21.8,0,584,595,4351
1995,40,l) Left Censored,27420,79118,3638363,3620588,4816,6,5831,7.3,418139,111234,306905,3.1,11.5,382688,99804,282884,2.8,10.6,35451,0.9,21.2,0,1289,1331,13721
1995,50,a) 0,35641,35839,155273,77637,35612,198.7,0,0,154563,154563,0,199.1,199.1,0,0,0,0,0,154563,199.1,0,0,,,
1995,50,b) 1,27236,27561,156192,153325,128,0.4,6335,20.5,46400,3130,43270,2,30.3,39445,23025,16420,15,25.7,6955,4.6,51.4,0,5137,5138,19254
1995,50,c) 2,22507,22749,138385,139960,651,2.7,3952,16.1,31523,2979,28544,2.1,22.5,34025,17508,16517,12.5,24.3,-2502,-1.8,45,0,3310,3311,15257
1995,50,d) 3,19875,20530,145763,144529,640,2.9,2881,13.3,29132,2700,26432,1.9,20.2,26349,13047,13302,9,18.2,2783,2,36.4,0,2378,2385,11019
1995,50,e) 4,18376,19234,145971,145127,583,2.9,2327,11.6,28204,2976,25228,2.1,19.4,26273,10488,15785,7.2,18.1,1931,1.3,36.2,0,1873,1874,8437
1995,50,f) 5,17319,17954,142007,141002,514,2.7,1977,10.6,24989,1990,22999,1.4,17.7,22733,11005,11728,7.8,16.1,2256,1.6,32.2,0,1569,1570,8492
1995,50,g) 6 to 10,69926,76146,758331,750579,2221,2.8,6840,8.7,120559,17354,103205,2.3,16.1,104198,43276,60922,5.8,13.9,16361,2.2,27.8,0,5098,5143,31767
1995,50,h) 11 to 15,48047,56596,690396,684118,1744,3,3919,6.8,93864,15844,78020,2.3,13.7,80916,27634,53282,4,11.8,12948,1.9,23.6,0,2467,2492,16038
1995,50,i) 16 to 20,24359,32568,467359,460029,935,2.8,1994,6,63802,11647,52155,2.5,13.9,48564,15549,33015,3.4,10.6,15238,3.3,21.2,0,1112,1150,6907
1995,50,l) Left Censored,82835,169998,3712421,3681360,7021,4.1,10672,6.2,476962,116994,359968,3.2,13,414558,129115,285443,3.5,11.3,62404,1.7,22.6,0,3258,3409,26725
1995,52,a) 0,113645,115113,798299,399150,114486,198.9,0,0,795908,795908,0,199.4,199.4,0,0,0,0,0,795908,199.4,0,0,,,
1995,52,b) 1,86035,88518,731429,768347,821,0.8,25590,25.1,171653,17498,154155,2.3,22.3,238982,137875,101107,17.9,31.1,-67329,-8.8,44.6,0,21807,21825,119331
1995,52,c) 2,69570,71653,615592,634905,2569,3.3,15802,20.1,131962,20674,111288,3.3,20.8,168035,95444,72591,15,26.5,-36073,-5.7,41.6,0,13612,13633,83933
1995,52,d) 3,58611,62897,560101,581554,2309,3.4,11716,17.3,97134,20322,76812,3.5,16.7,137943,73719,64224,12.7,23.7,-40809,-7,33.4,0,9526,9601,59912
1995,52,e) 4,53090,56970,527533,542218,2093,3.5,9088,15,87804,17657,70147,3.3,16.2,115870,58166,57704,10.7,21.4,-28066,-5.2,32.4,0,7199,7258,44220
1995,52,f) 5,48753,52803,494502,506033,1960,3.5,7761,13.9,77617,17681,59936,3.5,15.3,100120,46452,53668,9.2,19.8,-22503,-4.5,30.6,0,6230,6262,35896
1995,52,g) 6 to 10,187715,221064,2357521,2391555,8180,3.6,26078,11.3,347482,93849,253633,3.9,14.5,412205,176796,235409,7.4,17.2,-64723,-2.7,29,0,18943,19225,117308
1995,52,h) 11 to 15,114579,149402,1893002,1897912,6135,4,14455,9.4,272019,86286,185733,4.5,14.3,279872,111352,168520,5.9,14.7,-7853,-0.4,28.6,0,9208,9374,59381
1995,52,i) 16 to 20,60204,97847,1447123,1436709,4106,4.1,7975,8,210827,75103,135724,5.2,14.7,189271,61946,127325,4.3,13.2,21556,1.5,26.4,0,4242,4490,28062
1995,52,l) Left Censored,156662,490618,11528982,11399028,27778,5.6,39390,7.9,1599707,644890,954817,5.7,14,1337878,478803,859075,4.2,11.7,261829,2.3,23.4,0,10533,11015,68589
1995,60,a) 0,37940,38372,162516,81258,38070,198.4,0,0,161445,161445,0,198.7,198.7,0,0,0,0,0,161445,198.7,0,0,,,
1995,60,b) 1,29751,30246,156683,161682,229,0.7,8398,24.1,43712,4461,39251,2.8,27,51001,28688,22313,17.7,31.5,-7289,-4.5,54,0,6598,6598,23877
1995,60,c) 2,24294,24721,122779,133529,773,2.9,4711,17.5,24244,2981,21263,2.2,18.2,44602,23250,21352,17.4,33.4,-20358,-15.2,36.4,0,3777,3777,19940
1995,60,d) 3,19950,21007,119679,126530,708,3.2,3237,14.5,22242,3744,18498,3,17.6,34698,14910,19788,11.8,27.4,-12456,-9.8,35.2,0,2502,2516,10820
1995,60,e) 4,18317,20431,131214,135726,706,3.3,2461,11.5,18857,3111,15746,2.3,13.9,27278,10669,16609,7.9,20.1,-8421,-6.2,27.8,0,1802,1818,8343
1995,60,f) 5,17186,18533,111501,115996,735,3.8,2202,11.4,19241,4783,14458,4.1,16.6,27618,11505,16113,9.9,23.8,-8377,-7.2,33.2,0,1602,1618,7522
1995,60,g) 6 to 10,72063,79370,532497,550864,2769,3.4,7651,9.3,75363,13392,61971,2.4,13.7,111090,39374,71716,7.1,20.2,-35727,-6.5,27.4,0,5293,5342,24153
1995,60,h) 11 to 15,47437,55692,439100,445531,2276,4,4296,7.6,62144,16598,45546,3.7,13.9,74585,26176,48409,5.9,16.7,-12441,-2.8,27.8,0,2590,2636,13762
1995,60,i) 16 to 20,25051,32876,315195,318817,1251,3.7,2361,7.1,41155,12070,29085,3.8,12.9,48265,14658,33607,4.6,15.1,-7110,-2.2,25.8,0,1354,1364,5461
1995,60,l) Left Censored,84542,246812,4746225,4775040,18808,7.6,17021,6.9,599165,209962,389203,4.4,12.5,656085,180345,475740,3.8,13.7,-56920,-1.2,25,0,3527,3888,20464
1995,70,a) 0,190219,191864,1124096,562048,190517,198.6,0,0,1119480,1119480,0,199.2,199.2,0,0,0,0,0,1119480,199.2,0,0,,,
1995,70,b) 1,143241,145482,1146731,1116329,860,0.5,35444,21.5,352648,24935,327713,2.2,31.6,282487,151687,130800,13.6,25.3,70161,6.3,50.6,0,28212,28231,126271
1995,70,c) 2,118631,120673,1062241,1059002,3859,3,20821,16,259172,32997,226175,3.1,24.5,249516,132570,116946,12.5,23.6,9656,0.9,47.2,0,16834,16843,111640
1995,70,d) 3,103560,107532,1061501,1063237,3724,3.3,15660,13.8,214962,40929,174033,3.8,20.2,217031,106354,110677,10,20.4,-2069,-0.2,40.4,0,12225,12249,78018
1995,70,e) 4,94797,98677,875435,884469,3260,3.1,12750,12.3,167039,20232,146807,2.3,18.9,183099,81394,101705,9.2,20.7,-16060,-1.8,37.8,0,9743,9781,59978
1995,70,f) 5,88639,92388,909031,911975,3020,3.1,10985,11.4,160388,25073,135315,2.7,17.6,165782,68719,97063,7.5,18.2,-5394,-0.6,35.2,0,8348,8396,52281
1995,70,g) 6 to 10,360664,392372,5399769,5391360,13014,3.2,36502,9,748603,159640,588963,3,13.9,733406,268975,464431,5,13.6,15197,0.3,27.2,0,26203,26404,185103
1995,70,h) 11 to 15,269968,303407,3832208,3818050,9080,2.9,20554,6.6,525970,113458,412512,3,13.8,491081,149389,341692,3.9,12.9,34889,0.9,25.8,0,13434,13531,81019
1995,70,i) 16 to 20,120500,161367,2721643,2698099,5139,3.1,10461,6.4,372752,77908,294844,2.9,13.8,323942,84479,239463,3.1,12,48810,1.8,24,0,5826,5993,39518
1995,70,l) Left Censored,354943,508950,15515555,15405804,19505,3.8,28820,5.6,1766895,432730,1334165,2.8,11.5,1547330,391921,1155409,2.5,10,219565,1.5,20,0,15003,15212,107355
1996,07,a) 0,10151,10171,39258,19629,10012,196.9,0,0,38799,,,,197.7,0,0,0,0,0,38799,197.7,0,1,,,
1996,07,b) 1,8282,8289,40274,41100,7,0.1,2207,23.2,12631,,,,30.7,13522,6887,6635,16.8,32.9,-891,-2.2,61.4,1,1480,1480,4767
1996,07,c) 2,6512,6572,36999,36120,226,3.2,1029,14.7,10443,1565,8878,4.3,28.9,8620,3921,4699,10.9,23.9,1823,5,47.8,0,757,757,2582
1996,07,d) 3,5282,5326,32215,32800,196,3.5,769,13.7,7208,904,6304,2.8,22,7328,3182,4146,9.7,22.3,-120,-0.3,44,0,543,543,1890
1996,07,e) 4,5102,5114,29957,30322,193,3.6,669,12.5,6278,794,5484,2.6,20.7,6888,2814,4074,9.3,22.7,-610,-2,41.4,0,506,506,1980
1996,07,f) 5,4708,4718,31747,32682,159,3.2,609,12.3,5633,590,5043,1.8,17.2,7454,2844,4610,8.7,22.8,-1821,-5.6,34.4,0,435,435,1927
1996,07,g) 6 to 10,19949,20064,146111,146286,624,3,1920,9.3,26679,2914,23765,2,18.2,26808,8829,17979,6,18.3,-129,-0.1,36.4,0,1336,1336,6178
1996,07,h) 11 to 15,11109,11150,97883,98126,251,2.2,805,7,14046,867,13179,0.9,14.3,14454,4446,10008,4.5,14.7,-408,-0.4,28.6,0,544,544,3034
1996,07,i) 16 to 20,6232,6284,57816,57986,132,2.1,366,5.7,7170,514,6656,0.9,12.4,7388,1614,5774,2.8,12.7,-218,-0.3,24.8,0,229,229,952
1996,07,l) Left Censored,8841,9975,160575,156181,340,3.4,628,6.2,27453,8665,18788,5.5,17.6,17869,4918,12951,3.1,11.4,9584,6.2,22.8,0,402,402,1841
1996,10,a) 0,1428,1435,11003,5502,1421,198,0,0,10953,,,,199.1,0,0,0,0,0,10953,199.1,0,1,,,
1996,10,b) 1,1190,1193,15832,15118,6,0.4,367,26.5,5316,,,,35.2,3782,2385,1397,15.8,25,1534,10.2,50,1,308,308,2018
1996,10,c) 2,965,1104,14363,16050,30,2.5,245,20.1,2076,138,1938,0.9,12.9,5359,2357,3002,14.7,33.4,-3283,-20.5,25.8,0,195,195,2088
1996,10,d) 3,897,901,8764,9593,27,2.8,181,18.5,1636,228,1408,2.4,17.1,3273,2216,1057,23.1,34.1,-1637,-17,34.2,0,138,138,1902
1996,10,e) 4,796,805,8524,9290,28,3.3,140,16.3,1885,678,1207,7.3,20.3,3393,1989,1404,21.4,36.5,-1508,-16.2,40.6,0,115,115,1907
1996,10,f) 5,871,951,16406,17236,27,2.7,144,14.3,1575,232,1343,1.3,9.1,3241,1180,2061,6.8,18.8,-1666,-9.7,18.2,0,101,101,721
1996,10,g) 6 to 10,3301,3394,42093,44098,106,3,436,12.3,6021,472,5549,1.1,13.7,10044,3859,6185,8.8,22.8,-4023,-9.1,27.4,0,322,322,2681
1996,10,h) 11 to 15,3257,3443,43367,43905,96,2.7,362,10.1,6215,1157,5058,2.6,14.2,7563,3248,4315,7.4,17.2,-1348,-3,28.4,0,264,264,2400
1996,10,i) 16 to 20,1674,2051,32530,32759,73,3.5,153,7.3,4213,709,3504,2.2,12.9,5067,1061,4006,3.2,15.5,-854,-2.6,25.8,0,109,109,559
1996,10,l) Left Censored,4025,8058,334942,343154,424,5.2,712,8.7,37433,7422,30011,2.2,10.9,53778,17978,35800,5.2,15.7,-16345,-4.8,21.8,0,232,233,2171
1996,15,a) 0,66851,66865,284440,142220,65933,197.2,0,0,281598,281598,0,198,198,0,0,0,0,0,281598,198,0,0,,,
1996,15,b) 1,52202,52208,286150,291999,8,0,16846,27.4,93776,1856,91920,0.6,32.1,100341,57564,42777,19.7,34.4,-6565,-2.3,64.2,0,12834,12834,46892
1996,15,c) 2,41328,41401,261272,272822,1593,3.5,8762,19.4,66002,5822,60180,2.1,24.2,87385,39271,48114,14.4,32,-21383,-7.8,48.4,0,6761,6761,32884
1996,15,d) 3,33536,33545,225829,234592,1401,3.9,5967,16.6,52334,4834,47500,2.1,22.3,69184,30501,38683,13,29.5,-16850,-7.2,44.6,0,4585,4585,25629
1996,15,e) 4,27992,28027,208418,213185,1110,3.7,4293,14.5,45692,3887,41805,1.8,21.4,54988,20132,34856,9.4,25.8,-9296,-4.4,42.8,0,3216,3216,16076
1996,15,f) 5,25769,25947,190660,194658,1111,4.1,3534,13,41163,4020,37143,2.1,21.1,48969,17447,31522,9,25.2,-7806,-4.1,42.2,0,2564,2564,13728
1996,15,g) 6 to 10,114483,114672,926234,937690,4775,4,13348,11.2,179222,16410,162812,1.8,19.1,201557,58692,142865,6.3,21.5,-22335,-2.4,38.2,0,9440,9440,44842
1996,15,h) 11 to 15,64186,64584,718606,722869,2268,3.4,6069,9.1,121820,9387,112433,1.3,16.9,132809,32109,100700,4.4,18.4,-10989,-1.5,33.8,0,4164,4164,22423
1996,15,i) 16 to 20,44617,45126,484132,487543,1630,3.5,4212,9.1,77799,6127,71672,1.3,16,85890,19673,66217,4,17.6,-8091,-1.6,32,0,2912,2912,14289
1996,15,l) Left Censored,70258,74928,1544886,1554064,1795,2.3,6115,7.9,226524,22837,203687,1.5,14.6,248517,49252,199265,3.2,16,-21993,-1.4,29.2,0,4162,4162,22433
1996,20,a) 0,25227,25259,234861,117431,25072,198.5,0,0,233947,233947,0,199.2,199.2,0,0,0,0,0,233947,199.2,0,0,,,
1996,20,b) 1,20749,20812,238983,234564,101,0.4,5288,22.4,74219,8376,65843,3.6,31.6,63670,37117,26553,15.8,27.1,10549,4.5,54.2,0,4431,4431,31137
1996,20,c) 2,17782,17968,241890,252740,440,2.2,3522,18,48807,4354,44453,1.7,19.3,69798,40352,29446,16,27.6,-20991,-8.3,38.6,0,2976,2976,36007
1996,20,d) 3,15039,15132,203884,207811,431,2.7,2493,15.4,37500,4339,33161,2.1,18,45576,23773,21803,11.4,21.9,-8076,-3.9,36,0,2155,2155,21167
1996,20,e) 4,12782,12945,183995,189322,349,2.6,1788,13.1,29671,3784,25887,2,15.7,40634,18261,22373,9.6,21.5,-10963,-5.8,31.4,0,1500,1500,14957
1996,20,f) 5,12426,12775,210932,212900,364,2.7,1474,11.1,36161,6467,29694,3,17,40984,17209,23775,8.1,19.3,-4823,-2.3,34,0,1215,1215,12684
1996,20,g) 6 to 10,55028,56632,1234934,1243435,1272,2.2,5173,8.8,161299,21102,140197,1.7,13,181248,60764,120484,4.9,14.6,-19949,-1.6,26,0,4110,4111,42745
1996,20,h) 11 to 15,40080,43202,1447416,1451128,919,2.1,2975,6.7,154806,23399,131407,1.6,10.7,175450,52748,122702,3.6,12.1,-20644,-1.4,21.4,0,2136,2137,25035
1996,20,i) 16 to 20,26330,29744,1107244,1107583,601,2,1799,5.9,116360,16605,99755,1.5,10.5,123054,31327,91727,2.8,11.1,-6694,-0.6,21,0,1218,1218,13842
1996,20,l) Left Censored,76860,127794,13341747,13468796,3257,2.5,6871,5.3,1020296,215295,805001,1.6,7.6,1320093,330450,989643,2.5,9.8,-299797,-2.2,15.2,0,2849,2851,42567
1996,40,a) 0,25634,25796,136580,68290,25586,198.4,0,0,135672,135672,0,198.7,198.7,0,0,0,0,0,135672,198.7,0,0,,,
1996,40,b) 1,19401,19636,131224,133343,129,0.6,6057,26.5,39312,4076,35236,3.1,29.5,41830,24756,17074,18.6,31.4,-2518,-1.9,59,0,5030,5030,21347
1996,40,c) 2,15182,15545,120774,124340,474,2.8,3387,19.8,27952,2665,25287,2.1,22.5,34848,18594,16254,15,28,-6896,-5.5,45,0,2854,2854,16202
1996,40,d) 3,12164,12353,102197,105609,400,3,2234,16.8,20401,2652,17749,2.5,19.3,27087,13422,13665,12.7,25.6,-6686,-6.3,38.6,0,1893,1893,11593
1996,40,e) 4,9925,10726,101483,104572,363,3.2,1818,15.9,18400,2809,15591,2.7,17.6,24494,10770,13724,10.3,23.4,-6094,-5.8,35.2,0,1312,1312,8410
1996,40,f) 5,9002,9734,109077,109896,332,3.2,1303,12.7,19976,2973,17003,2.7,18.2,21436,8720,12716,7.9,19.5,-1460,-1.3,36.4,0,1044,1044,6016
1996,40,g) 6 to 10,35320,39774,496798,503832,1360,3.3,4491,10.9,76402,12684,63718,2.5,15.2,90734,34153,56581,6.8,18,-14332,-2.8,30.4,0,3210,3211,23298
1996,40,h) 11 to 15,20131,30606,719991,724755,1302,4.2,2842,9.1,88162,16581,71581,2.3,12.2,99750,26189,73561,3.6,13.8,-11588,-1.6,24.4,0,1444,1445,11471
1996,40,i) 16 to 20,11902,18743,412907,409276,763,4,1475,7.7,53591,11611,41980,2.8,13.1,46278,14362,31916,3.5,11.3,7313,1.8,22.6,0,745,745,5327
1996,40,l) Left Censored,26027,78231,3656371,3651877,6652,8.5,7407,9.4,505532,173191,332341,4.7,13.8,499070,180596,318474,4.9,13.7,6462,0.1,27.4,0,1199,1200,11552
1996,50,a) 0,35687,35870,157537,78769,35592,198.4,0,0,156707,156707,0,198.9,198.9,0,0,0,0,0,156707,198.9,0,0,,,
1996,50,b) 1,28328,28677,159989,157540,227,0.7,6874,21.3,48832,6285,42547,4,31,42482,24654,17828,15.6,27,6350,4,54,0,5599,5599,20670
1996,50,c) 2,23423,23836,147486,150859,683,2.7,4225,16.4,31596,3128,28468,2.1,20.9,38078,18821,19257,12.5,25.2,-6482,-4.3,41.8,0,3475,3475,15739
1996,50,d) 3,19827,20130,129987,133922,588,2.7,3126,14.6,24033,2397,21636,1.8,17.9,31784,15610,16174,11.7,23.7,-7751,-5.8,35.8,0,2643,2643,12934
1996,50,e) 4,17903,18537,137391,140776,502,2.6,2418,12.4,22744,2405,20339,1.7,16.2,29243,13291,15952,9.4,20.8,-6499,-4.6,32.4,0,1949,1949,10402
1996,50,f) 5,16833,17898,147163,147106,612,3.3,1977,10.6,26439,3762,22677,2.6,18,26382,10447,15935,7.1,17.9,57,0.1,35.8,0,1590,1590,8639
1996,50,g) 6 to 10,69240,74772,722969,727996,2281,3,7030,9.1,106819,17235,89584,2.4,14.7,118433,44555,73878,6.1,16.3,-11614,-1.6,29.4,0,5235,5235,32909
1996,50,h) 11 to 15,49821,58949,737523,743164,1867,3.1,4485,7.4,92494,16682,75812,2.2,12.4,106599,37443,69156,5,14.3,-14105,-1.9,24.8,0,2822,2822,20667
1996,50,i) 16 to 20,30854,40671,562849,567126,1488,3.6,2892,7,69579,16568,53011,2.9,12.3,79893,28260,51633,5,14.1,-10314,-1.8,24.6,0,1453,1456,10619
1996,50,l) Left Censored,78754,166263,3674696,3696407,7900,4.7,11795,7,441655,115173,326482,3.1,11.9,491391,163510,327881,4.4,13.3,-49736,-1.4,23.8,0,3216,3218,27977
1996,52,a) 0,115371,117489,819367,409684,116707,198.7,0,0,816096,816096,0,199.2,199.2,0,0,0,0,0,816096,199.2,0,0,,,
1996,52,b) 1,86538,88721,710227,755514,1093,1.1,25904,25.4,159759,21978,137781,2.9,21.1,245197,134485,110712,17.8,32.5,-85438,-11.4,42.2,0,22153,22156,117597
1996,52,c) 2,71296,74142,650355,689422,2564,3.2,16495,20.3,118709,27155,91554,3.9,17.2,193058,106460,86598,15.4,28,-74349,-10.8,34.4,0,14081,14084,91879
1996,52,d) 3,59534,62054,546825,580328,2262,3.4,11605,17.4,92085,21057,71028,3.6,15.9,157669,89115,68554,15.4,27.2,-65584,-11.3,31.8,0,9852,9853,79619
1996,52,e) 4,51242,55868,525334,541118,2219,3.7,9114,15.4,84930,21199,63731,3.9,15.7,116860,55540,61320,10.3,21.6,-31930,-5.9,31.4,0,7376,7378,43220
1996,52,f) 5,47130,51020,497057,509311,1884,3.5,7578,14.1,78492,20343,58149,4,15.4,103959,47961,55998,9.4,20.4,-25467,-5,30.8,0,6113,6115,37825
1996,52,g) 6 to 10,185260,216325,2318304,2365927,8001,3.5,26516,11.8,337399,102128,235271,4.3,14.3,434148,182821,251327,7.7,18.4,-96749,-4.1,28.6,0,19541,19548,120191
1996,52,h) 11 to 15,117719,151949,1930323,1959675,5476,3.5,14890,9.5,248807,74460,174347,3.8,12.7,309045,115299,193746,5.9,15.8,-60238,-3.1,25.4,0,9672,9676,62103
1996,52,i) 16 to 20,74038,118597,1767098,1764568,4644,3.8,10080,8.3,241450,83062,158388,4.7,13.7,237608,78911,158697,4.5,13.5,3842,0.2,27,0,5286,5298,33407
1996,52,l) Left Censored,146106,482134,11590678,11572906,26848,5.5,35794,7.4,1519250,600485,918765,5.2,13.1,1490217,470349,1019868,4.1,12.9,29033,0.2,25.8,0,9905,9912,64053
1996,60,a) 0,38623,39119,159486,79743,38752,198.1,0,0,157914,157914,0,198,198,0,0,0,0,0,157914,198,0,0,,,
1996,60,b) 1,29789,31370,172587,170406,663,1.9,7331,20.9,52179,7059,45120,4.1,30.6,45293,24999,20294,14.7,26.6,6886,4,53.2,0,5626,5626,20673
1996,60,c) 2,25778,26422,154359,154615,950,3.4,4473,15.8,37053,4865,32188,3.1,24,37016,18053,18963,11.7,23.9,37,0.1,47.8,0,3527,3527,13751
1996,60,d) 3,21660,22172,114427,116562,783,3.3,3188,13.6,23095,3293,19802,2.8,19.8,27316,12530,14786,10.7,23.4,-4221,-3.6,39.6,0,2491,2491,10125
1996,60,e) 4,18206,19321,119999,120564,683,3.4,2374,11.8,21781,3477,18304,2.9,18.1,23399,9908,13491,8.2,19.4,-1618,-1.3,36.2,0,1781,1781,7455
1996,60,f) 5,16952,19033,131748,132029,660,3.3,2087,10.6,21018,3190,17828,2.4,15.9,22336,8678,13658,6.6,16.9,-1318,-1,31.8,0,1472,1472,5715
1996,60,g) 6 to 10,71809,78851,539953,541019,2950,3.6,7617,9.4,89960,20849,69111,3.9,16.6,94428,36890,57538,6.8,17.5,-4468,-0.9,33.2,0,5252,5253,23352
1996,60,h) 11 to 15,49759,58430,464937,467828,1928,3.2,4466,7.5,63276,12954,50322,2.8,13.5,71748,29473,42275,6.3,15.3,-8472,-1.8,27,0,2841,2843,15586
1996,60,i) 16 to 20,31709,41095,393397,391601,1789,4.3,3090,7.4,55688,14374,41314,3.7,14.2,52725,16456,36269,4.2,13.5,2963,0.7,27,0,1794,1794,6072
1996,60,l) Left Censored,79769,240909,4740807,4739929,15007,6.2,18858,7.8,661295,225017,436278,4.7,14,658270,214087,444183,4.5,13.9,3025,0.1,27.8,0,3526,3527,17931
1996,70,a) 0,196082,197342,1151576,575788,195814,198.5,0,0,1144767,1144767,0,198.8,198.8,0,0,0,0,0,1144767,198.8,0,0,,,
1996,70,b) 1,149704,152157,1197033,1159664,1057,0.6,37129,21.6,386717,32937,353780,2.8,33.3,303803,163302,140501,14.1,26.2,82914,7.1,52.4,0,29155,29155,130860
1996,70,c) 2,123435,125981,1068987,1094242,3913,2.9,22231,16.4,234373,27891,206482,2.5,21.4,281581,139732,141849,12.8,25.7,-47208,-4.3,42.8,0,17911,17911,119174
1996,70,d) 3,105334,107868,1050219,1052720,3745,3.3,15912,13.9,227730,32170,195560,3.1,21.6,230545,105660,124885,10,21.9,-2815,-0.3,43.2,0,12708,12709,87775
1996,70,e) 4,93441,97574,996183,1022749,3213,3.1,12785,12.5,179600,39820,139780,3.9,17.6,232411,85326,147085,8.3,22.7,-52811,-5.1,35.2,0,9998,9999,67865
1996,70,f) 5,86812,91155,850541,863093,3256,3.4,10786,11.4,146426,24630,121796,2.9,17,171728,70148,101580,8.1,19.9,-25302,-2.9,34,0,8238,8241,55134
1996,70,g) 6 to 10,356064,385053,5224441,5282855,12441,3.1,37445,9.4,682792,125243,557549,2.4,12.9,809294,290243,519051,5.5,15.3,-126502,-2.4,25.8,0,26840,26844,195852
1996,70,h) 11 to 15,281120,319299,4268725,4267479,10058,3.1,22780,7,588955,133022,455933,3.1,13.8,591247,177460,413787,4.2,13.9,-2292,-0.1,27.6,0,14409,14411,96326
1996,70,i) 16 to 20,153975,200578,3251411,3264865,6268,3.1,13105,6.4,407391,104744,302647,3.2,12.5,437527,154552,282975,4.7,13.4,-30136,-0.9,25,0,7406,7408,46110
1996,70,l) Left Censored,338898,494479,15631256,15577795,19103,3.8,31988,6.4,1846424,491131,1355293,3.2,11.9,1765777,490105,1275672,3.1,11.3,80647,0.6,22.6,0,14763,14785,101671
1997,07,a) 0,10600,10602,38712,19356,10448,197.1,0,0,38245,,,,197.6,0,0,0,0,0,38245,197.6,0,1,,,
1997,07,b) 1,7920,7940,40532,41527,2,0,2010,22.2,12388,,,,29.8,13542,6090,7452,14.7,32.6,-1154,-2.8,59.6,1,1404,1404,4394
1997,07,c) 2,7082,7157,35195,36579,302,3.9,1300,16.9,9359,1387,7972,3.8,25.6,10468,5200,5268,14.2,28.6,-1109,-3,51.2,0,950,950,3451
1997,07,d) 3,5766,5932,36395,35528,303,4.9,897,14.4,10252,3285,6967,9.2,28.9,8454,3816,4638,10.7,23.8,1798,5.1,47.6,0,644,644,2655
1997,07,e) 4,4798,4845,29697,30240,177,3.5,613,12.1,6067,749,5318,2.5,20.1,6954,3022,3932,10,23,-887,-2.9,40.2,0,434,434,2295
1997,07,f) 5,4682,4699,31569,31996,138,2.8,574,11.7,5584,556,5028,1.7,17.5,6467,3042,3425,9.5,20.2,-883,-2.7,35,0,409,409,2308
1997,07,g) 6 to 10,20182,20292,153722,156194,697,3.3,1915,9.2,28153,3144,25009,2,18,32985,9959,23026,6.4,21.1,-4832,-3.1,36,0,1314,1314,7004
1997,07,h) 11 to 15,11823,11845,104225,104221,321,2.6,912,7.5,16054,1746,14308,1.7,15.4,16047,5196,10851,5,15.4,7,0,30.8,0,600,600,3436
1997,07,i) 16 to 20,7762,7814,75398,75264,203,2.6,474,6,10143,1289,8854,1.7,13.5,9751,2713,7038,3.6,13,392,0.5,26,0,321,321,1987
1997,07,l) Left Censored,8447,9647,165957,158405,354,3.6,612,6.3,35444,4650,30794,2.9,22.4,20452,7522,12930,4.7,12.9,14992,9.5,25.8,0,390,390,2712
1997,10,a) 0,1568,1578,12202,6101,1566,198.5,0,0,12178,12178,0,199.6,199.6,0,0,0,0,0,12178,199.6,0,0,,,
1997,10,b) 1,1112,1130,10299,10907,6,0.5,288,22.5,2944,335,2609,3.1,27,4098,1797,2301,16.5,37.6,-1154,-10.6,54,0,218,218,1373
1997,10,c) 2,970,973,12981,14213,26,2.4,216,20.1,3057,195,2862,1.4,21.5,5433,4354,1079,30.6,38.2,-2376,-16.7,43,0,186,186,3774
1997,10,d) 3,849,999,11448,12504,44,4.2,143,13.7,2311,449,1862,3.6,18.5,4432,2905,1527,23.2,35.4,-2121,-16.9,37,0,107,107,2655
1997,10,e) 4,795,802,8321,8450,32,3.8,120,14.2,1750,294,1456,3.5,20.7,2005,637,1368,7.5,23.7,-255,-3,41.4,0,92,92,543
1997,10,f) 5,714,735,7908,8055,32,4.2,86,11.3,1305,154,1151,1.9,16.2,1497,456,1041,5.7,18.6,-192,-2.4,32.4,0,75,75,429
1997,10,g) 6 to 10,3214,3397,46171,48521,131,3.7,404,11.4,7532,1541,5991,3.2,15.5,12173,6542,5631,13.5,25.1,-4641,-9.6,31,0,300,300,2613
1997,10,h) 11 to 15,2968,3185,47352,46047,135,4.1,330,10.1,9913,1969,7944,4.3,21.5,8598,3169,5429,6.9,18.7,1315,2.8,37.4,0,224,224,1671
1997,10,i) 16 to 20,2237,2740,44418,44510,158,5.7,263,9.4,10212,4846,5366,10.9,22.9,10504,3739,6765,8.4,23.6,-292,-0.7,45.8,0,150,150,2591
1997,10,l) Left Censored,3783,7566,324198,327137,365,4.7,826,10.6,50909,11964,38945,3.7,15.6,59102,19910,39192,6.1,18.1,-8193,-2.5,31.2,0,216,216,2169
1997,15,a) 0,67893,67916,292740,146370,67140,197.7,0,0,290727,290727,0,198.6,198.6,0,0,0,0,0,290727,198.6,0,0,,,
1997,15,b) 1,49566,49588,280702,282117,19,0,15581,26.8,93833,737,93096,0.3,33.3,92097,53539,38558,19,32.6,1736,0.7,65.2,0,11895,11895,43989
1997,15,c) 2,44185,44192,268030,276499,1698,3.5,9274,19.2,71299,6620,64679,2.4,25.8,87083,41935,45148,15.2,31.5,-15784,-5.7,51.6,0,7130,7130,34422
1997,15,d) 3,36268,36337,253490,256770,1485,3.8,6387,16.4,62352,7384,54968,2.9,24.3,68414,30164,38250,11.7,26.6,-6062,-2.3,48.6,0,4838,4838,24681
1997,15,e) 4,30032,30048,217585,220829,1222,3.8,4555,14.3,50000,4177,45823,1.9,22.6,55892,22658,33234,10.3,25.3,-5892,-2.7,45.2,0,3447,3447,18526
1997,15,f) 5,25479,25513,204157,206192,1069,4,3489,13,44899,3947,40952,1.9,21.8,48600,18235,30365,8.8,23.6,-3701,-1.8,43.6,0,2598,2598,14912
1997,15,g) 6 to 10,112554,112865,941281,939202,4840,4.1,12606,10.8,191097,17188,173909,1.8,20.3,186250,60419,125831,6.4,19.8,4847,0.5,39.6,0,8982,8982,46579
1997,15,h) 11 to 15,69661,69982,769157,765769,2605,3.6,6222,8.7,140239,12595,127644,1.6,18.3,132264,34710,97554,4.5,17.3,7975,1,34.6,0,4288,4288,22063
1997,15,i) 16 to 20,52484,53103,628589,623918,1888,3.5,4447,8.2,108339,10109,98230,1.6,17.4,98325,23172,75153,3.7,15.8,10014,1.6,31.6,0,3102,3102,15200
1997,15,l) Left Censored,66686,71273,1569257,1560090,1897,2.6,5492,7.5,256354,24859,231495,1.6,16.4,238388,56881,181507,3.6,15.3,17966,1.1,30.6,0,3691,3691,21798
1997,20,a) 0,24896,24969,241407,120704,24818,198.8,0,0,240655,240655,0,199.4,199.4,0,0,0,0,0,240655,199.4,0,0,,,
1997,20,b) 1,19784,19894,240056,234351,186,0.8,5026,22.3,77812,13946,63866,6,33.2,64446,41352,23094,17.6,27.5,13366,5.7,55,0,4200,4200,35044
1997,20,c) 2,17581,17656,218810,225411,428,2.2,3378,17.6,47515,3494,44021,1.6,21.1,60674,35549,25125,15.8,26.9,-13159,-5.8,42.2,0,2880,2880,31891
1997,20,d) 3,15587,15822,233063,236903,445,2.6,2522,14.9,43046,3564,39482,1.5,18.2,50720,26595,24125,11.2,21.4,-7674,-3.2,36.4,0,2133,2133,21216
1997,20,e) 4,13385,13485,192750,196405,314,2.2,1913,13.4,32968,2191,30777,1.1,16.8,39945,21483,18462,10.9,20.3,-6977,-3.5,33.6,0,1572,1572,18750
1997,20,f) 5,11611,11791,189028,186425,283,2.3,1389,11.2,35957,2362,33595,1.3,19.3,30462,12473,17989,6.7,16.3,5495,3,32.6,0,1132,1132,9704
1997,20,g) 6 to 10,53329,54986,1164469,1163663,1237,2.2,5338,9.4,160369,15257,145112,1.3,13.8,157477,63586,93891,5.5,13.5,2892,0.3,27,0,4158,4158,46029
1997,20,h) 11 to 15,39901,42637,1391484,1385772,905,2.1,3156,7.2,166207,21788,144419,1.6,12,155303,49700,105603,3.6,11.2,10904,0.8,22.4,0,2278,2278,24862
1997,20,i) 16 to 20,32414,36827,1453189,1451117,792,2.1,2290,6.1,159553,24564,134989,1.7,11,155756,44303,111453,3.1,10.7,3797,0.3,21.4,0,1485,1485,18900
1997,20,l) Left Censored,73641,123232,13195660,13281429,2780,2.2,7579,6,1141468,166945,974523,1.3,8.6,1312284,428546,883738,3.2,9.9,-170816,-1.3,17.2,0,2796,2796,41131
1997,40,a) 0,25078,25552,134659,67330,25339,198.3,0,0,133963,133963,0,199,199,0,0,0,0,0,133963,199,0,0,,,
1997,40,b) 1,18939,19322,136095,135598,198,0.9,6174,27.4,46293,9119,37174,6.7,34.1,43829,28647,15182,21.1,32.3,2464,1.8,64.6,0,5094,5094,25060
1997,40,c) 2,15815,16128,117747,121674,507,2.8,3781,21.2,28493,3418,25075,2.8,23.4,35891,21119,14772,17.4,29.5,-7398,-6.1,46.8,0,3153,3153,18496
1997,40,d) 3,12948,13416,116730,118266,436,3,2499,17.3,27598,3856,23742,3.3,23.3,30262,16581,13681,14,25.6,-2664,-2.3,46.6,0,2099,2099,13984
1997,40,e) 4,10504,10758,93011,97038,317,2.7,1847,16,17121,1697,15424,1.7,17.6,24857,13391,11466,13.8,25.6,-7736,-8,35.2,0,1547,1548,11562
1997,40,f) 5,8793,9626,97366,99152,317,3.1,1406,13.8,18883,3185,15698,3.2,19,22373,9874,12499,10,22.6,-3490,-3.6,38,0,1050,1050,7006
1997,40,g) 6 to 10,35031,40325,495737,496137,2339,5.6,4794,11.5,98065,27018,71047,5.4,19.8,98144,43696,54448,8.8,19.8,-79,0,39.6,0,3423,3423,25234
1997,40,h) 11 to 15,20987,31866,731234,720466,1821,5.6,3040,9.4,132885,26364,106521,3.7,18.4,110238,34687,75551,4.8,15.3,22647,3.1,30.6,0,1555,1556,14626
1997,40,i) 16 to 20,14418,22261,488535,479420,1269,5.6,1774,7.9,75159,20057,55102,4.2,15.7,56638,18470,38168,3.9,11.8,18521,3.9,23.6,0,893,893,7398
1997,40,l) Left Censored,24781,76872,3735296,3734996,5865,7.5,8187,10.5,502511,166850,335661,4.5,13.5,504353,160498,343855,4.3,13.5,-1842,0,27,0,1149,1149,11199
1997,50,a) 0,33487,33812,145577,72789,33579,198.6,0,0,145013,145013,0,199.2,199.2,0,0,0,0,0,145013,199.2,0,0,,,
1997,50,b) 1,28294,28664,161643,157971,290,0.9,6893,21.4,51954,8347,43607,5.3,32.9,43348,27315,16033,17.3,27.4,8606,5.5,54.8,0,5545,5545,22167
1997,50,c) 2,23928,24313,144801,149599,631,2.4,4622,17.5,30595,2401,28194,1.6,20.5,39864,21522,18342,14.4,26.6,-9269,-6.1,41,0,3856,3856,18610
1997,50,d) 3,20564,21009,142085,143754,621,2.8,3248,14.5,28432,3244,25188,2.3,19.8,31476,15189,16287,10.6,21.9,-3044,-2.1,39.6,0,2644,2645,12511
1997,50,e) 4,17697,18126,126201,127569,543,2.8,2426,12.7,24534,2686,21848,2.1,19.2,26887,12998,13889,10.2,21.1,-2353,-1.9,38.4,0,1987,1987,9620
1997,50,f) 5,16246,16880,137293,136653,485,2.7,2045,11.6,25284,2757,22527,2,18.5,23496,9231,14265,6.8,17.2,1788,1.3,34.4,0,1605,1605,7078
1997,50,g) 6 to 10,67906,73318,713909,714612,1978,2.6,7191,9.5,111684,16112,95572,2.3,15.6,111637,44502,67135,6.2,15.6,47,0,31.2,0,5275,5275,30940
1997,50,h) 11 to 15,49836,58791,726637,728852,1962,3.3,4930,8.2,103195,16242,86953,2.2,14.2,106336,37093,69243,5.1,14.6,-3141,-0.4,28.4,0,2963,2963,20375
1997,50,i) 16 to 20,38139,50507,724487,725767,2061,4,3692,7.2,100399,22911,77488,3.2,13.8,101733,30785,70948,4.2,14,-1334,-0.2,27.6,0,1818,1818,14029
1997,50,l) Left Censored,75195,161431,3697506,3695916,7589,4.6,13601,8.3,542720,132200,410520,3.6,14.7,540925,206198,334727,5.6,14.6,1795,0.1,29.2,0,3014,3014,32915
1997,52,a) 0,113528,116349,808396,404198,115601,198.7,0,0,805652,805652,0,199.3,199.3,0,0,0,0,0,805652,199.3,0,0,,,
1997,52,b) 1,86738,90060,718628,769068,1334,1.3,27075,26.1,169935,27692,142243,3.6,22.1,264293,154921,109372,20.1,34.4,-94358,-12.3,44.2,0,22924,22924,129824
1997,52,c) 2,70964,74334,614210,654029,3095,3.8,16813,20.7,116193,24991,91202,3.8,17.8,193343,111120,82223,17,29.6,-77150,-11.8,35.6,0,14304,14304,95159
1997,52,d) 3,60425,64043,583651,612494,2538,3.7,12334,17.9,103293,26052,77241,4.3,16.9,159518,83964,75554,13.7,26,-56225,-9.1,33.8,0,10349,10349,69522
1997,52,e) 4,51419,54832,496242,518966,2297,3.9,9404,16.1,82502,19656,62846,3.8,15.9,127256,62482,64774,12,24.5,-44754,-8.6,31.8,0,7767,7767,50735
1997,52,f) 5,44859,49971,492814,507191,2149,4.1,7847,14.8,83090,20867,62223,4.1,16.4,110410,51957,58453,10.2,21.8,-27320,-5.4,32.8,0,6131,6131,39186
1997,52,g) 6 to 10,180542,209315,2267400,2318986,9120,4.2,27871,12.7,362863,109698,253165,4.7,15.6,462024,198081,263943,8.5,19.9,-99161,-4.3,31.2,0,19630,19630,126244
1997,52,h) 11 to 15,117955,152374,1929965,1962816,6973,4.4,17224,10.9,283310,96984,186326,4.9,14.4,346542,127547,218995,6.5,17.7,-63232,-3.3,28.8,0,10185,10185,64454
1997,52,i) 16 to 20,88404,140269,2107855,2123653,8206,5.7,14955,10.4,339507,147347,192160,6.9,16,370197,129428,240769,6.1,17.4,-30690,-1.4,32,0,6261,6261,40551
1997,52,l) Left Censored,137346,472617,11756533,11718436,31381,6.5,45015,9.4,1765455,649557,1115898,5.5,15.1,1680446,564544,1115902,4.8,14.3,85009,0.8,28.6,0,9161,9161,63117
1997,60,a) 0,40372,41470,174249,87125,41135,198.4,0,0,173429,173429,0,199.1,199.1,0,0,0,0,0,173429,199.1,0,0,,,
1997,60,b) 1,30180,31106,160462,159241,438,1.3,7515,21.5,50657,5641,45016,3.5,31.8,46234,29112,17122,18.3,29,4423,2.8,58,0,5707,5707,23425
1997,60,c) 2,25506,27320,148952,158187,1210,4.1,4861,16.6,34861,6437,28424,4.1,22,52425,31780,20645,20.1,33.1,-17564,-11.1,44,0,3555,3555,24776
1997,60,d) 3,22742,23661,146066,147119,1007,4,3534,14.1,33851,6334,27517,4.3,23,35270,17499,17771,11.9,24,-1419,-1,46,0,2692,2692,12897
1997,60,e) 4,19523,20274,111079,112452,765,3.6,2554,12,23439,3634,19805,3.2,20.8,25543,13131,12412,11.7,22.7,-2104,-1.9,41.6,0,1988,1988,10372
1997,60,f) 5,16583,17787,110617,112444,740,4,2136,11.5,21316,4450,16866,4,19,24816,11321,13495,10.1,22.1,-3500,-3.1,38,0,1518,1518,7859
1997,60,g) 6 to 10,70767,79935,574770,576126,3867,4.7,8080,9.8,112703,30298,82405,5.3,19.6,116299,47249,69050,8.2,20.2,-3596,-0.6,39.2,0,5337,5337,25443
1997,60,h) 11 to 15,50852,59912,463608,466441,2938,4.8,5262,8.6,76974,18442,58532,4,16.5,82236,34871,47365,7.5,17.6,-5262,-1.1,33,0,3133,3133,15041
1997,60,i) 16 to 20,38604,50706,498955,492573,3157,6.2,4068,7.9,89602,28616,60986,5.8,18.2,76616,29364,47252,6,15.6,12986,2.6,31.2,0,1951,1951,8573
1997,60,l) Left Censored,76835,242346,4810513,4789731,27617,11.4,26994,11.1,936934,388395,548539,8.1,19.6,890446,392052,498394,8.2,18.6,46488,1,37.2,0,3144,3144,26544
1997,70,a) 0,202727,205732,1204875,602438,204264,198.6,0,0,1200041,,,,199.2,0,0,0,0,0,1200041,199.2,0,1,,,
1997,70,b) 1,152161,155035,1227900,1193665,1521,0.9,40121,22.8,406322,,,,34,328248,180259,147989,15.1,27.5,78074,6.5,55,1,31490,31490,147258
1997,70,c) 2,128068,131428,1115987,1133343,4623,3.3,23798,16.8,280357,37026,243331,3.3,24.7,310574,159150,151424,14,27.4,-30217,-2.7,49.4,0,18849,18849,131887
1997,70,d) 3,108541,111473,1014132,1029625,3748,3.2,17384,14.7,219840,31484,188356,3.1,21.4,248842,125265,123577,12.2,24.2,-29002,-2.8,42.8,0,13563,13563,99246
1997,70,e) 4,94354,98255,981241,1008697,3832,3.7,13171,12.8,193907,38271,155636,3.8,19.2,245573,105270,140303,10.4,24.3,-51666,-5.1,38.4,0,10357,10357,80093
1997,70,f) 5,84449,89119,1002315,1002624,3030,3.2,11229,12,189898,30706,159192,3.1,18.9,191475,84022,107453,8.4,19.1,-1577,-0.2,37.8,0,8408,8408,63625
1997,70,g) 6 to 10,350463,379115,5005037,5046530,14798,3.8,39175,10,810386,175531,634855,3.5,16.1,892468,319966,572502,6.3,17.7,-82082,-1.6,32.2,0,27392,27392,191973
1997,70,h) 11 to 15,283851,324195,4325309,4328478,13468,4.1,25385,7.7,692427,188131,504296,4.3,16,695008,263699,431309,6.1,16.1,-2581,-0.1,32,0,15060,15061,124302
1997,70,i) 16 to 20,190676,248368,4245039,4220595,11953,4.7,19149,7.6,659462,192641,466821,4.6,15.6,608650,171301,437349,4.1,14.4,50812,1.2,28.8,0,9337,9337,67237
1997,70,l) Left Censored,324979,492840,16058645,15918707,27821,5.6,35317,7.1,2272763,636875,1635888,4,14.3,1992600,589342,1403258,3.7,12.5,280163,1.8,25,0,14200,14202,112321
1998,07,a) 0,10379,10379,37795,18898,10238,197.3,0,0,37441,,,,198.1,0,0,0,0,0,37441,198.1,0,1,,,
1998,07,b) 1,8166,8167,36889,38197,1,0,2248,23.9,10353,,,,27.1,12314,7183,5131,18.8,32.2,-1961,-5.1,54.2,1,1567,1567,5127
1998,07,c) 2,6716,6745,35021,35594,205,2.8,1266,17.3,8169,723,7446,2,23,9229,4338,4891,12.2,25.9,-1060,-2.9,46,0,885,885,3200
1998,07,d) 3,6246,6316,33546,34323,208,3.1,1003,14.9,7562,1160,6402,3.4,22,8974,3766,5208,11,26.1,-1412,-4.1,44,0,728,728,3025
1998,07,e) 4,5157,5343,34858,35567,187,3.3,748,13.3,7303,1042,6261,2.9,20.5,8621,3451,5170,9.7,24.2,-1318,-3.7,41,0,554,554,2278
1998,07,f) 5,4404,4459,30174,29947,140,3,521,11.2,6150,791,5359,2.6,20.5,5774,2039,3735,6.8,19.3,376,1.2,38.6,0,395,395,1579
1998,07,g) 6 to 10,20112,20158,151815,154143,637,3.1,1944,9.3,26236,2952,23284,1.9,17,30915,8837,22078,5.7,20.1,-4679,-3.1,34,0,1380,1380,6579
1998,07,h) 11 to 15,12682,12801,113348,114015,390,3,995,7.6,16135,1687,14448,1.5,14.2,17473,5236,12237,4.6,15.3,-1338,-1.1,28.4,0,663,663,3594
1998,07,i) 16 to 20,7881,7924,77163,77980,147,1.8,468,5.8,8887,674,8213,0.9,11.4,10393,2337,8056,3,13.3,-1506,-1.9,22.8,0,326,326,1632
1998,07,j) 21 to 25,1321,1343,14231,14464,26,1.9,101,7.3,1648,130,1518,0.9,11.4,2108,658,1450,4.5,14.6,-460,-3.2,22.8,0,75,75,441
1998,07,l) Left Censored,7918,9120,152443,158651,330,3.5,715,7.7,22631,6340,16291,4,14.3,34783,9314,25469,5.9,21.9,-12152,-7.6,28.6,0,409,409,2262
1998,10,a) 0,1479,1479,12243,6122,1469,198.6,0,0,12228,,,,199.7,0,0,0,0,0,12228,199.7,0,1,,,
1998,10,b) 1,1204,1224,10499,11537,8,0.6,342,24.4,3142,,,,27.2,5178,2955,2223,25.6,44.9,-2036,-17.7,54.4,1,273,273,2654
1998,10,c) 2,923,942,9257,9726,26,2.5,191,18.5,2486,239,2247,2.5,25.6,3307,1796,1511,18.5,34,-821,-8.4,51.2,0,158,158,1580
1998,10,d) 3,824,829,10113,11455,18,2,157,17.5,1777,228,1549,2,15.5,4461,1116,3345,9.7,38.9,-2684,-23.4,31,0,120,120,927
1998,10,e) 4,747,906,11675,11678,23,2.4,128,13.4,2495,298,2197,2.6,21.4,2507,1143,1364,9.8,21.5,-12,-0.1,42.8,0,100,100,838
1998,10,f) 5,720,733,8136,8498,25,3.2,99,12.8,1421,126,1295,1.5,16.7,2113,1045,1068,12.3,24.9,-692,-8.2,33.4,0,78,78,960
1998,10,g) 6 to 10,3083,3187,33935,35667,97,2.9,381,11.4,5454,1305,4149,3.7,15.3,9299,4911,4388,13.8,26.1,-3845,-10.8,30.6,0,272,272,3367
1998,10,h) 11 to 15,2585,2780,42786,43522,72,2.5,280,9.7,8555,1134,7421,2.6,19.7,10017,4160,5857,9.6,23,-1462,-3.3,39.4,0,198,198,1724
1998,10,i) 16 to 20,2380,2608,39152,40217,71,2.6,238,8.8,5479,826,4653,2.1,13.6,7487,3622,3865,9,18.6,-2008,-5,27.2,0,155,155,2851
1998,10,j) 21 to 25,343,676,12663,13466,17,2.4,98,13.7,2004,114,1890,0.8,14.9,3554,2194,1360,16.3,26.4,-1550,-11.5,29.8,0,21,21,618
1998,10,l) Left Censored,3541,7247,327188,329521,393,5.3,710,9.6,49725,12545,37180,3.8,15.1,54245,16902,37343,5.1,16.5,-4520,-1.4,30.2,0,183,183,2198
1998,15,a) 0,65361,65368,282358,141179,64659,197.8,0,0,280128,,,,198.4,0,0,0,0,0,280128,198.4,0,1,,,
1998,15,b) 1,49657,49718,286324,289660,38,0.1,16648,28.3,94635,,,,32.7,96701,56690,40011,19.6,33.4,-2066,-0.7,65.4,1,12565,12565,45340
1998,15,c) 2,41649,41686,259021,269537,1527,3.3,8987,19.7,66718,5799,60919,2.2,24.8,86467,40057,46410,14.9,32.1,-19749,-7.3,49.6,0,6849,6849,31224
1998,15,d) 3,38493,38500,253634,260632,1540,3.7,6957,16.8,60193,6653,53540,2.6,23.1,73357,31783,41574,12.2,28.1,-13164,-5,46.2,0,5213,5213,25175
1998,15,e) 4,32337,32411,240516,246061,1343,3.9,5118,14.9,53359,5981,47378,2.4,21.7,63809,24721,39088,10,25.9,-10450,-4.2,43.4,0,3832,3832,20041
1998,15,f) 5,27250,27268,207398,212510,1049,3.7,3776,13.2,42051,3542,38509,1.7,19.8,51804,18705,33099,8.8,24.4,-9753,-4.6,39.6,0,2783,2783,14911
1998,15,g) 6 to 10,109504,109661,933163,944883,4305,3.8,12345,10.8,173561,16028,157533,1.7,18.4,194866,62224,132642,6.6,20.6,-21305,-2.2,36.8,0,8648,8648,46539
1998,15,h) 11 to 15,76253,76610,822322,829407,2755,3.5,6987,8.9,136202,11064,125138,1.3,16.4,149773,41203,108570,5,18.1,-13571,-1.7,32.8,0,4849,4849,26922
1998,15,i) 16 to 20,49151,49796,629524,633195,1549,3,4222,8.2,96994,6553,90441,1,15.3,103804,26127,77677,4.1,16.4,-6810,-1.1,30.6,0,2951,2951,17161
1998,15,j) 21 to 25,9172,9307,115123,116313,305,3.2,836,8.7,17763,1450,16313,1.2,15.3,19553,4154,15399,3.6,16.8,-1790,-1.5,30.6,0,566,566,2581
1998,15,l) Left Censored,62777,67563,1572108,1569685,1643,2.4,5165,7.4,241000,28003,212997,1.8,15.4,232997,46281,186716,2.9,14.8,8003,0.6,29.6,0,3613,3613,25169
1998,20,a) 0,24297,24312,230388,115194,24150,198.7,0,0,229054,229054,0,198.8,198.8,0,0,0,0,0,229054,198.8,0,0,,,
1998,20,b) 1,19583,19701,256397,251901,69,0.3,4984,22.3,76156,5944,70212,2.4,30.2,65992,42212,23780,16.8,26.2,10164,4,52.4,0,4110,4110,33134
1998,20,c) 2,16661,16822,223565,228734,435,2.4,3415,18.6,55073,8874,46199,3.9,24.1,64746,38471,26275,16.8,28.3,-9673,-4.2,48.2,0,2880,2880,32926
1998,20,d) 3,15292,15381,207749,211954,380,2.3,2589,15.7,39087,3181,35906,1.5,18.4,47421,24749,22672,11.7,22.4,-8334,-4,36.8,0,2201,2201,21193
1998,20,e) 4,13828,14065,222387,225694,346,2.3,2024,13.6,37879,4828,33051,2.1,16.8,43868,19590,24278,8.7,19.4,-5989,-2.6,33.6,0,1671,1671,16532
1998,20,f) 5,12071,12179,183976,186906,286,2.2,1531,11.9,29666,4430,25236,2.4,15.9,35069,15114,19955,8.1,18.8,-5403,-2.9,31.8,0,1264,1264,12009
1998,20,g) 6 to 10,51200,52716,1101139,1103623,1189,2.2,5070,9.3,156073,20325,135748,1.8,14.1,159634,61012,98622,5.5,14.5,-3561,-0.4,28.2,0,4035,4035,42613
1998,20,h) 11 to 15,40091,42418,1320227,1329156,817,1.9,3098,7.1,144578,18636,125942,1.4,10.9,161587,46037,115550,3.5,12.2,-17009,-1.3,21.8,0,2290,2290,26643
1998,20,i) 16 to 20,31325,34947,1323984,1325120,683,1.9,2097,5.9,149372,18978,130394,1.4,11.3,150698,41194,109504,3.1,11.4,-1326,-0.1,22.6,0,1442,1442,17437
1998,20,j) 21 to 25,6151,7892,433278,430078,195,2.4,518,6.4,49433,8996,40437,2.1,11.5,43096,12564,30532,2.9,10,6337,1.5,20,0,254,254,2969
1998,20,l) Left Censored,70333,120273,13220657,13213299,3212,2.6,6367,5.2,1136993,203317,933676,1.5,8.6,1120800,294102,826698,2.2,8.5,16193,0.1,17,0,2503,2503,40358
1998,40,a) 0,24585,24739,130338,65169,24544,198.4,0,0,129446,129446,0,198.6,198.6,0,0,0,0,0,129446,198.6,0,0,,,
1998,40,b) 1,18568,19029,135680,133843,95,0.4,6172,27.7,41795,3130,38665,2.3,31.2,37273,23898,13375,17.9,27.8,4522,3.4,55.6,0,5034,5034,20662
1998,40,c) 2,15593,15954,120605,126946,488,2.8,3695,21,28951,3239,25712,2.6,22.8,41157,25330,15827,20,32.4,-12206,-9.6,45.6,0,3122,3122,22031
1998,40,d) 3,13510,13855,106747,111124,494,3.3,2687,17.9,22694,2742,19952,2.5,20.4,31187,15733,15454,14.2,28.1,-8493,-7.7,40.8,0,2229,2229,12961
1998,40,e) 4,11233,11739,114640,116532,372,3,2023,16.1,23816,2983,20833,2.6,20.4,27512,14225,13287,12.2,23.6,-3696,-3.2,40.8,0,1658,1658,10815
1998,40,f) 5,9307,9598,90686,92305,274,2.7,1441,14.1,17332,2094,15238,2.3,18.8,20004,9248,10756,10,21.7,-2672,-2.9,37.6,0,1172,1172,7340
1998,40,g) 6 to 10,34124,38745,479727,482397,1656,4.1,4594,11.4,87121,20216,66905,4.2,18.1,93112,41238,51874,8.5,19.3,-5991,-1.2,36.2,0,3454,3454,27713
1998,40,h) 11 to 15,22059,31038,603583,598240,1790,5.7,2868,9.1,100139,29759,70380,5,16.7,89941,34981,54960,5.8,15,10198,1.7,30,0,1682,1682,13276
1998,40,i) 16 to 20,13878,23200,517126,528443,1537,6.6,2022,8.6,90585,20205,70380,3.8,17.1,114199,68250,45949,12.9,21.6,-23614,-4.5,34.2,0,957,957,19898
1998,40,j) 21 to 25,2695,7444,263815,253328,715,9.7,612,8.3,44557,20690,23867,8.2,17.6,23666,8451,15215,3.3,9.3,20891,8.3,18.6,0,156,156,922
1998,40,l) Left Censored,23316,78329,3742126,3718902,8600,11.1,6233,8.1,482133,170575,311558,4.6,13,432076,124055,308021,3.3,11.6,50057,1.4,23.2,0,1167,1167,13240
1998,50,a) 0,29747,29797,135423,67712,29603,198.7,0,0,134947,134947,0,199.3,199.3,0,0,0,0,0,134947,199.3,0,0,,,
1998,50,b) 1,25882,26267,143255,143616,83,0.3,7173,23.9,40448,3774,36674,2.6,28.2,40003,25668,14335,17.9,27.9,445,0.3,55.8,0,5906,5906,21237
1998,50,c) 2,23962,24318,147452,153014,579,2.2,4689,17.7,31713,2518,29195,1.6,20.7,42172,23560,18612,15.4,27.6,-10459,-6.9,41.4,0,3937,3937,21307
1998,50,d) 3,20938,21289,137534,139373,515,2.3,3375,14.8,27152,2031,25121,1.5,19.5,30426,15020,15406,10.8,21.8,-3274,-2.3,39,0,2781,2781,12340
1998,50,e) 4,18365,18848,135422,138449,430,2.2,2580,12.9,22894,1720,21174,1.2,16.5,28864,13807,15057,10,20.8,-5970,-4.3,33,0,2111,2111,11702
1998,50,f) 5,15997,16408,122405,123840,401,2.3,2049,11.9,20103,1989,18114,1.6,16.2,22722,9928,12794,8,18.3,-2619,-2.1,32.4,0,1700,1700,7844
1998,50,g) 6 to 10,66463,71087,687373,698298,1546,2.1,7100,9.6,97476,10179,87297,1.5,14,118056,44351,73705,6.4,16.9,-20580,-2.9,28,0,5385,5385,32285
1998,50,h) 11 to 15,49995,58214,712716,717532,1360,2.3,4684,7.8,92695,11616,81079,1.6,12.9,101482,37105,64377,5.2,14.1,-8787,-1.2,25.8,0,3018,3018,21533
1998,50,i) 16 to 20,36507,45097,641102,638813,1067,2.3,3136,6.8,84145,13617,70528,2.1,13.2,79158,25758,53400,4,12.4,4987,0.8,24.8,0,1888,1888,14949
1998,50,j) 21 to 25,7610,13806,243388,243473,477,3.4,831,5.9,29333,5559,23774,2.3,12,29341,9651,19690,4,12.1,-8,-0.1,24,0,344,344,2170
1998,50,l) Left Censored,71262,157206,3722725,3712071,7542,4.7,11444,7.2,493603,117881,375722,3.2,13.3,473256,165990,307266,4.5,12.7,20347,0.6,25.4,0,2971,2971,29620
1998,52,a) 0,107275,107921,763208,381604,107307,198.9,0,0,761183,761183,0,199.5,199.5,0,0,0,0,0,761183,199.5,0,0,,,
1998,52,b) 1,85517,88491,709403,757464,450,0.4,26768,26.1,159690,18328,141362,2.4,21.1,249376,143021,106355,18.9,32.9,-89686,-11.8,42.2,0,22602,22602,120165
1998,52,c) 2,71470,74884,632156,672773,2104,2.6,16907,20.5,111183,18505,92678,2.8,16.5,191091,105216,85875,15.6,28.4,-79908,-11.9,33,0,14344,14344,88832
1998,52,d) 3,60552,64011,551977,580175,2114,3.1,11983,17.3,90534,16528,74006,2.8,15.6,145313,76988,68325,13.3,25,-54779,-9.4,31.2,0,10167,10167,65799
1998,52,e) 4,52399,55883,528922,553241,1649,2.8,9455,15.8,81130,16150,64980,2.9,14.7,128747,62162,66585,11.2,23.3,-47617,-8.6,29.4,0,7818,7818,49454
1998,52,f) 5,45291,48907,459351,477799,1603,3.1,7457,14.4,68020,12370,55650,2.6,14.2,103983,50935,53048,10.7,21.8,-35963,-7.6,28.4,0,6116,6116,41078
1998,52,g) 6 to 10,175153,201177,2200971,2253611,6450,3.1,25056,11.9,316456,73386,243070,3.3,14,419491,176507,242984,7.8,18.6,-103035,-4.6,28,0,18831,18831,122084
1998,52,h) 11 to 15,120233,155490,2017680,2037200,5142,3.2,15269,9.5,268100,62967,205133,3.1,13.2,305151,120216,184935,5.9,15,-37051,-1.8,26.4,0,10173,10173,67300
1998,52,i) 16 to 20,81375,115498,1761982,1770863,3441,2.9,10354,8.7,239509,66909,172600,3.8,13.5,255805,89538,166267,5.1,14.4,-16296,-0.9,27,0,5964,5964,41181
1998,52,j) 21 to 25,18255,42607,691660,693791,2154,5,3604,8.3,110792,38048,72744,5.5,16,114952,53157,61795,7.7,16.6,-4160,-0.6,32,0,1095,1095,6974
1998,52,l) Left Censored,127794,463102,11772108,11753420,25841,5.5,34384,7.4,1500911,519568,981343,4.4,12.8,1460347,501246,959101,4.3,12.4,40564,0.4,24.8,0,8446,8446,60654
1998,60,a) 0,39975,40096,163040,81520,39794,198.5,0,0,162317,162317,0,199.1,199.1,0,0,0,0,0,162317,199.1,0,0,,,
1998,60,b) 1,31474,32673,172227,170367,184,0.5,8189,22.1,53247,3897,49350,2.3,31.3,48092,28930,19162,17,28.2,5155,3.1,56.4,0,6273,6273,22900
1998,60,c) 2,26037,26983,144157,150153,831,2.9,4653,16,32416,3310,29106,2.2,21.6,43927,23043,20884,15.3,29.3,-11511,-7.7,43.2,0,3641,3641,18951
1998,60,d) 3,22642,24365,144066,145712,1139,4.4,3801,14.8,33738,6403,27335,4.4,23.2,36601,18741,17860,12.9,25.1,-2863,-1.9,46.4,0,2682,2682,13417
1998,60,e) 4,20507,21493,140857,142183,797,3.5,2903,12.9,29508,5350,24158,3.8,20.8,32001,14780,17221,10.4,22.5,-2493,-1.7,41.6,0,2186,2186,11215
1998,60,f) 5,17776,18508,112404,113629,548,2.8,2280,11.8,20589,2647,17942,2.3,18.1,23136,10949,12187,9.6,20.4,-2547,-2.3,36.2,0,1765,1765,8509
1998,60,g) 6 to 10,68753,76876,549553,554501,2636,3.3,7595,9.6,96757,17572,79185,3.2,17.4,106956,45838,61118,8.3,19.3,-10199,-1.9,34.8,0,5223,5223,26106
1998,60,h) 11 to 15,52920,61819,458226,461457,2428,3.8,5084,8,72134,16031,56103,3.5,15.6,75878,31444,44434,6.8,16.4,-3744,-0.8,31.2,0,3217,3217,16166
1998,60,i) 16 to 20,37026,45354,399352,400472,1647,3.6,3284,7.1,59316,13920,45396,3.5,14.8,62080,24763,37317,6.2,15.5,-2764,-0.7,29.6,0,1907,1927,9298
1998,60,j) 21 to 25,7487,15293,226463,219325,880,5.7,965,6.3,42377,12110,30267,5.5,19.3,29176,8315,20861,3.8,13.3,13201,6,26.6,0,367,367,1521
1998,60,l) Left Censored,73157,238389,4798436,4814160,21785,9.1,25415,10.6,775680,268196,507484,5.6,16.1,814376,327595,486781,6.8,16.9,-38696,-0.8,32.2,0,3078,3078,19756
1998,70,a) 0,201747,202452,1155604,577802,200990,198.6,0,0,1150622,1150622,0,199.1,199.1,0,0,0,0,0,1150622,199.1,0,0,,,
1998,70,b) 1,157047,160311,1302691,1257640,528,0.3,42360,23.2,417272,19014,398258,1.5,33.2,317535,181164,136371,14.4,25.2,99737,8,50.4,0,33491,33491,149603
1998,70,c) 2,130173,133349,1185065,1201320,4331,3,24917,17.3,273794,38965,234829,3.2,22.8,301699,155521,146178,12.9,25.1,-27905,-2.3,45.6,0,19881,19881,127954
1998,70,d) 3,113045,116586,1069768,1087813,3780,3,17997,14.5,216692,28800,187892,2.6,19.9,250789,116331,134458,10.7,23.1,-34097,-3.2,39.8,0,14038,14038,91726
1998,70,e) 4,97586,100311,973207,989235,2956,2.8,13618,12.9,190233,20758,169475,2.1,19.2,217303,92737,124566,9.4,22,-27070,-2.8,38.4,0,10601,10601,75164
1998,70,f) 5,85464,89710,947873,960354,2795,3,11241,12,187051,29321,157730,3.1,19.5,211233,92327,118906,9.6,22,-24182,-2.5,39,0,8612,8612,67526
1998,70,g) 6 to 10,344148,368707,4432762,4457725,10903,2.9,37592,9.8,727336,117861,609475,2.6,16.3,772604,302153,470451,6.8,17.3,-45268,-1,32.6,0,27196,27196,195502
1998,70,h) 11 to 15,286723,327623,5038383,5033795,10092,3,24414,7.3,669365,158388,510977,3.1,13.3,657877,219718,438159,4.4,13.1,11488,0.2,26.2,0,15413,15413,106529
1998,70,i) 16 to 20,187194,224179,3498513,3484590,6140,2.7,15504,6.8,467781,96306,371475,2.8,13.4,438197,132050,306147,3.8,12.6,29584,0.8,25.2,0,9244,9244,57701
1998,70,j) 21 to 25,36064,65866,1687136,1669382,2920,4.4,4408,6.6,252492,61693,190799,3.7,15.1,214940,58376,156564,3.5,12.9,37552,2.2,25.8,0,1595,1595,12102
1998,70,l) Left Censored,309854,485941,16330560,16169654,24201,4.9,31702,6.5,2067326,555594,1511732,3.4,12.8,1741549,490292,1251257,3,10.8,325777,2,21.6,0,13377,13377,105799
1999,07,a) 0,10640,10642,39371,19686,10521,197.7,0,0,38971,38971,0,198,198,0,0,0,0,0,38971,198,0,0,,,
1999,07,b) 1,8039,8039,38929,38366,0,0,2182,23.7,11517,0,11517,0,30,10004,5947,4057,15.5,26.1,1513,3.9,52.2,0,1478,1478,4165
1999,07,c) 2,7016,7017,46422,41137,194,2.6,1264,16.7,19623,901,18722,2.2,47.7,9017,4594,4423,11.2,21.9,10606,25.8,43.8,0,912,912,3578
1999,07,d) 3,6001,6106,36111,35341,270,4.2,882,13.7,8913,1345,7568,3.8,25.2,7287,2995,4292,8.5,20.6,1626,4.6,41.2,0,631,631,2149
1999,07,e) 4,5680,5714,34142,33793,181,3,769,12.8,8046,594,7452,1.8,23.8,7388,3089,4299,9.1,21.9,658,1.9,43.8,0,539,539,2289
1999,07,f) 5,4695,4893,33776,34100,163,3.2,586,11.5,6669,827,5842,2.4,19.6,7183,2611,4572,7.7,21.1,-514,-1.5,39.2,0,412,412,1980
1999,07,g) 6 to 10,19635,19735,156744,154407,579,2.8,1953,9.6,31082,2969,28113,1.9,20.1,26480,10004,16476,6.5,17.1,4602,3,34.2,0,1332,1332,6567
1999,07,h) 11 to 15,13617,13742,123030,123131,324,2.3,1015,7.2,18455,1613,16842,1.3,15,18644,6095,12549,5,15.1,-189,-0.1,30,0,660,660,4532
1999,07,i) 16 to 20,7984,8019,81757,80425,176,2.1,509,6.2,12464,832,11632,1,15.5,9639,2963,6676,3.7,12,2825,3.5,24,0,374,374,2237
1999,07,j) 21 to 25,2586,2622,27083,27351,60,2.2,162,6.1,3909,414,3495,1.5,14.3,4435,2340,2095,8.6,16.2,-526,-1.9,28.6,0,104,104,1881
1999,07,l) Left Censored,7509,8732,155035,154547,235,2.6,588,6.6,20911,3140,17771,2,13.5,19983,4846,15137,3.1,12.9,928,0.6,25.8,0,379,379,2722
1999,10,a) 0,1190,1195,8456,4228,1188,198.8,0,0,8420,8420,0,199.1,199.1,0,0,0,0,0,8420,199.1,0,0,,,
1999,10,b) 1,1058,1058,7880,8960,0,0,383,30.3,1828,0,1828,0,20.4,3892,2496,1396,27.9,43.4,-2064,-23,40.8,0,301,301,1916
1999,10,c) 2,979,1001,8094,8968,25,2.3,232,20.9,1578,213,1365,2.4,17.6,3272,1715,1557,19.1,36.5,-1694,-18.9,35.2,0,180,180,1433
1999,10,d) 3,769,795,7292,8228,25,2.9,165,19,1164,434,730,5.3,14.1,3012,1064,1948,12.9,36.6,-1848,-22.5,28.2,0,118,118,931
1999,10,e) 4,711,712,6099,7781,23,3,127,16.6,715,135,580,1.7,9.2,4139,2754,1385,35.4,53.2,-3424,-44,18.4,0,98,98,2585
1999,10,f) 5,643,819,10072,10685,33,3.8,119,13.8,1369,256,1113,2.4,12.8,2567,791,1776,7.4,24,-1198,-11.2,25.6,0,84,84,570
1999,10,g) 6 to 10,2854,2943,29040,31833,72,2.3,467,14.8,3109,494,2615,1.6,9.8,8651,2949,5702,9.3,27.2,-5542,-17.4,19.6,0,324,324,2002
1999,10,h) 11 to 15,2381,2530,28342,31406,85,3.2,303,11.4,4213,951,3262,3,13.4,10198,5331,4867,17,32.5,-5985,-19.1,26.8,0,196,196,1048
1999,10,i) 16 to 20,2264,2499,37742,39373,63,2.4,291,11.1,5345,1049,4296,2.7,13.6,8586,2108,6478,5.4,21.8,-3241,-8.2,27.2,0,190,190,1288
1999,10,j) 21 to 25,642,1119,22236,23256,112,10,101,9.1,3637,1878,1759,8.1,15.6,5571,1669,3902,7.2,24,-1934,-8.4,31.2,0,43,43,541
1999,10,l) Left Censored,3302,6984,313271,323208,292,4.1,561,7.9,33807,6275,27532,1.9,10.5,53442,12722,40720,3.9,16.5,-19635,-6,21,0,176,176,1384
1999,15,a) 0,64890,64899,289227,144614,64161,197.7,0,0,287000,287000,0,198.5,198.5,0,0,0,0,0,287000,198.5,0,0,,,
1999,15,b) 1,49117,49127,280492,280494,10,0,14968,26.2,94240,147,94093,0.1,33.6,89825,54056,35769,19.3,32,4415,1.6,64,0,11022,11022,42871
1999,15,c) 2,42333,42400,279879,282591,1599,3.5,8670,18.8,74269,5768,68501,2,26.3,78752,40097,38655,14.2,27.9,-4483,-1.6,52.6,0,6561,6561,31584
1999,15,d) 3,36809,36819,253103,255062,1492,3.8,6262,16,62421,5591,56830,2.2,24.5,66166,30678,35488,12,25.9,-3745,-1.4,49,0,4691,4691,24120
1999,15,e) 4,34611,34616,252195,252686,1416,3.9,5268,14.4,59247,4895,54352,1.9,23.4,59806,25775,34031,10.2,23.7,-559,-0.3,46.8,0,3875,3875,20516
1999,15,f) 5,29609,29661,242390,240299,1160,3.7,3900,12.6,53730,4081,49649,1.7,22.4,49596,18880,30716,7.9,20.6,4134,1.8,41.2,0,2856,2856,14890
1999,15,g) 6 to 10,109131,109287,979963,971179,4039,3.6,11886,10.5,199961,15536,184425,1.6,20.6,180566,62801,117765,6.5,18.6,19395,2,37.2,0,8384,8384,46180
1999,15,h) 11 to 15,81826,82197,896958,889471,2910,3.4,7412,8.8,158601,14474,144127,1.6,17.8,142675,41580,101095,4.7,16,15926,1.8,32,0,5073,5073,29466
1999,15,i) 16 to 20,46492,47118,647101,636330,1363,2.8,3597,7.5,113603,13627,99976,2.1,17.9,91478,22910,68568,3.6,14.4,22125,3.5,28.8,0,2469,2469,16252
1999,15,j) 21 to 25,17998,18279,231123,232656,585,3.1,1607,8.5,34296,3091,31205,1.3,14.7,37505,10989,26516,4.7,16.1,-3209,-1.4,29.4,0,1102,1102,7281
1999,15,l) Left Censored,59533,64509,1615292,1599508,1432,2.2,4526,6.8,250768,25342,225426,1.6,15.7,218685,52081,166604,3.3,13.7,32083,2,27.4,0,3171,3171,24481
1999,20,a) 0,22049,22074,209209,104605,21908,198.5,0,0,208141,208141,0,199,199,0,0,0,0,0,208141,199,0,0,,,
1999,20,b) 1,18861,18899,217120,219865,59,0.3,5039,23.4,60643,5486,55157,2.5,27.6,63889,41007,22882,18.7,29.1,-3246,-1.5,55.2,0,4090,4090,34650
1999,20,c) 2,16408,16527,223065,233267,359,2,3392,18.8,43223,3675,39548,1.6,18.5,63527,38283,25244,16.4,27.2,-20304,-8.7,37,0,2809,2809,32151
1999,20,d) 3,14429,14598,195021,207609,366,2.3,2512,16,32785,3350,29435,1.6,15.8,50566,26181,24385,12.6,24.4,-17781,-8.6,31.6,0,2091,2091,21265
1999,20,e) 4,13560,13678,198449,202217,332,2.3,1992,13.7,32701,4217,28484,2.1,16.2,39660,17866,21794,8.8,19.6,-6959,-3.4,32.4,0,1660,1660,15095
1999,20,f) 5,12358,12628,206010,213984,296,2.2,1711,12.8,29406,4808,24598,2.2,13.7,44965,18713,26252,8.7,21,-15559,-7.3,27.4,0,1410,1410,15388
1999,20,g) 6 to 10,49435,50773,965741,988511,1087,2.1,5202,9.8,122172,12932,109240,1.3,12.4,167336,60471,106865,6.1,16.9,-45164,-4.5,24.8,0,4064,4064,42786
1999,20,h) 11 to 15,40722,43009,1308083,1337116,810,1.8,3284,7.4,139431,27208,112223,2,10.4,196302,54169,142133,4.1,14.7,-56871,-4.3,20.8,0,2436,2436,34756
1999,20,i) 16 to 20,30095,34091,1306609,1326006,704,2,2266,6.5,130383,23855,106528,1.8,9.8,168976,47390,121586,3.6,12.7,-38593,-2.9,19.6,0,1527,1527,19579
1999,20,j) 21 to 25,11137,13482,657889,662780,303,2.2,846,6.1,63943,12417,51526,1.9,9.6,73488,20739,52749,3.1,11.1,-9545,-1.5,19.2,0,512,512,7377
1999,20,l) Left Censored,67111,117100,12900837,13059439,2987,2.5,6337,5.3,975751,189459,786292,1.5,7.5,1292825,330825,962000,2.5,9.9,-317074,-2.4,15,0,2448,2448,40782
1999,40,a) 0,25123,25309,141025,70513,25063,198.1,0,0,140197,140197,0,198.8,198.8,0,0,0,0,0,140197,198.8,0,0,,,
1999,40,b) 1,18335,18595,127775,127539,101,0.5,5840,27,42099,4449,37650,3.5,33,40455,26169,14286,20.5,31.7,1644,1.3,63.4,0,4827,4827,23161
1999,40,c) 2,15189,15654,124341,129243,476,2.7,3687,21.3,30477,4297,26180,3.3,23.6,39730,23429,16301,18.1,30.7,-9253,-7.1,47.2,0,3018,3018,19297
1999,40,d) 3,13255,13599,113972,116278,393,2.7,2719,18.4,24089,3518,20571,3,20.7,28878,15315,13563,13.2,24.8,-4789,-4.1,41.4,0,2204,2204,13055
1999,40,e) 4,11741,12239,99325,102694,476,3.6,2180,16.7,19227,2977,16250,2.9,18.7,26202,14054,12148,13.7,25.5,-6975,-6.8,37.4,0,1758,1758,10877
1999,40,f) 5,9899,10461,108613,110045,452,4.1,1707,15.4,25872,11114,14758,10.1,23.5,28615,17057,11558,15.5,26,-2743,-2.5,47,0,1300,1300,7578
1999,40,g) 6 to 10,34191,38083,467744,470915,1392,3.5,4735,11.9,82954,16039,66915,3.4,17.6,89460,41461,47999,8.8,19,-6506,-1.4,35.2,0,3432,3432,25159
1999,40,h) 11 to 15,22761,31154,587426,594095,1897,6,3059,9.6,90740,24872,65868,4.2,15.3,101847,40226,61621,6.8,17.1,-11107,-1.8,30.6,0,1810,1810,12478
1999,40,i) 16 to 20,13563,25144,617995,609429,1413,5.5,2554,9.9,101632,28448,73184,4.7,16.7,84188,30018,54170,4.9,13.8,17444,2.9,27.6,0,937,937,7349
1999,40,j) 21 to 25,4756,10478,343979,340739,464,4.4,612,5.8,30787,8688,22099,2.5,9,24501,6393,18108,1.9,7.2,6286,1.8,14.4,0,303,303,2193
1999,40,l) Left Censored,22116,76885,3759579,3730391,6789,8.8,7817,10.1,535573,197685,337888,5.3,14.4,480538,183625,296913,4.9,12.9,55035,1.5,25.8,0,1175,1175,12656
1999,50,a) 0,28108,28176,132364,66182,27991,198.7,0,0,131810,131810,0,199.2,199.2,0,0,0,0,0,131810,199.2,0,0,,,
1999,50,b) 1,23211,23275,132467,131799,38,0.1,6150,23.2,37800,2191,35609,1.7,28.7,35323,22755,12568,17.3,26.8,2477,1.9,53.6,0,4982,4982,19137
1999,50,c) 2,21814,22210,136656,138367,541,2.2,4456,18.4,32291,2498,29793,1.8,23.3,35483,21430,14053,15.5,25.6,-3192,-2.3,46.6,0,3614,3614,17372
1999,50,d) 3,20781,21134,138806,143230,506,2.2,3599,15.8,24999,2139,22860,1.5,17.5,33959,18270,15689,12.8,23.7,-8960,-6.2,35,0,2872,2872,13382
1999,50,e) 4,18548,18891,131167,134024,448,2.2,2792,13.9,22769,2097,20672,1.6,17,28160,14174,13986,10.6,21,-5391,-4,34,0,2268,2268,12117
1999,50,f) 5,16523,16996,130274,132451,421,2.4,2221,12.4,21256,1631,19625,1.2,16,25453,12111,13342,9.1,19.2,-4197,-3.2,32,0,1717,1717,9723
1999,50,g) 6 to 10,65057,68488,654458,650276,1431,2,7326,10.2,112122,9854,102268,1.5,17.2,103153,43497,59656,6.7,15.9,8969,1.3,31.8,0,5519,5519,32692
1999,50,h) 11 to 15,50035,58347,741533,742585,1626,2.7,4730,7.9,101757,26297,75460,3.5,13.7,103111,39654,63457,5.3,13.9,-1354,-0.2,27.4,0,3198,3198,22202
1999,50,i) 16 to 20,35750,44824,665205,665448,1110,2.4,3142,6.9,86044,16793,69251,2.5,12.9,85725,28923,56802,4.3,12.9,319,0,25.8,0,1921,1921,13487
1999,50,j) 21 to 25,13205,20786,366137,364904,699,3.3,1688,7.9,50016,14791,35225,4.1,13.7,47463,17196,30267,4.7,13,2553,0.7,26,0,566,566,3938
1999,50,l) Left Censored,67474,154104,3719437,3718228,6893,4.4,9846,6.3,463433,131124,332309,3.5,12.5,460053,156767,303286,4.2,12.4,3380,0.1,24.8,0,2787,2787,25435
1999,52,a) 0,103921,105117,765095,382548,104548,198.9,0,0,762889,762889,0,199.4,199.4,0,0,0,0,0,762889,199.4,0,0,,,
1999,52,b) 1,81580,82962,674577,717324,657,0.7,24412,25.6,156191,21971,134220,3.1,21.8,237804,140084,97720,19.5,33.2,-81613,-11.4,43.6,0,20404,20404,118736
1999,52,c) 2,70807,74344,628667,669293,2099,2.6,16523,20.2,107744,19331,88413,2.9,16.1,187406,105899,81507,15.8,28,-79662,-11.9,32.2,0,13582,13582,87168
1999,52,d) 3,60946,64147,570666,598756,1936,2.8,12521,18,91265,15818,75447,2.6,15.2,146432,79577,66855,13.3,24.5,-55167,-9.3,30.4,0,10121,10121,61722
1999,52,e) 4,52719,56313,513893,532591,1651,2.7,9302,15.5,77414,13979,63435,2.6,14.5,114416,56897,57519,10.7,21.5,-37002,-7,29,0,7506,7506,44481
1999,52,f) 5,46054,49422,488825,507228,1432,2.7,7707,14.7,67960,11532,56428,2.3,13.4,104310,51642,52668,10.2,20.6,-36350,-7.2,26.8,0,6162,6162,38957
1999,52,g) 6 to 10,172179,195938,2116196,2173788,5770,2.8,24379,11.9,278050,62201,215849,2.9,12.8,392098,171872,220226,7.9,18,-114048,-5.2,25.6,0,18437,18437,119008
1999,52,h) 11 to 15,120816,155789,2090279,2112511,5206,3.2,15680,9.7,280676,85791,194885,4.1,13.3,322424,131700,190724,6.2,15.3,-41748,-2,26.6,0,10072,10072,65442
1999,52,i) 16 to 20,78808,112442,1720278,1720085,3733,3.2,9307,8.1,225695,76751,148944,4.5,13.1,225298,78399,146899,4.6,13.1,397,0,26.2,0,5808,5808,39161
1999,52,j) 21 to 25,30642,61673,1043818,1040994,2596,4.1,4808,7.7,147663,49787,97876,4.8,14.2,141836,46209,95627,4.4,13.6,5827,0.6,27.2,0,2016,2016,13181
1999,52,l) Left Censored,118958,453627,11822230,11806812,22280,4.9,31958,7,1479072,514488,964584,4.4,12.5,1454917,450840,1004077,3.8,12.3,24155,0.2,24.6,0,7912,7912,59200
1999,60,a) 0,41993,42161,187579,93790,41829,198.4,0,0,186524,186524,0,198.9,198.9,0,0,0,0,0,186524,198.9,0,0,,,
1999,60,b) 1,31637,31993,159125,160139,273,0.8,7816,21.7,46920,2186,44734,1.4,29.3,47630,29726,17904,18.6,29.7,-710,-0.4,58.6,0,5898,5898,22608
1999,60,c) 2,27022,28191,153657,159134,911,3,5142,16.9,34497,5707,28790,3.6,21.7,44926,26321,18605,16.5,28.2,-10429,-6.5,43.4,0,3900,3900,20648
1999,60,d) 3,23082,23980,134195,137396,784,3.1,3624,14.2,26326,3987,22339,2.9,19.2,32169,16826,15343,12.2,23.4,-5843,-4.2,38.4,0,2733,2733,11668
1999,60,e) 4,20376,22223,146131,143563,1146,4.9,3184,13.7,37642,10076,27566,7,26.2,32369,15002,17367,10.4,22.5,5273,3.7,45,0,2169,2169,10557
1999,60,f) 5,18698,19776,140359,139354,844,4.1,2531,12.3,29442,5515,23927,4,21.1,27302,14051,13251,10.1,19.6,2140,1.5,39.2,0,1868,1868,9282
1999,60,g) 6 to 10,68846,76596,542864,552282,2441,3.1,7743,9.8,87084,17204,69880,3.1,15.8,105032,47425,57607,8.6,19,-17948,-3.2,31.6,0,5471,5471,26008
1999,60,h) 11 to 15,53611,63107,481734,483215,2324,3.6,5306,8.2,74189,16486,57703,3.4,15.4,78792,31618,47174,6.5,16.3,-4603,-0.9,30.8,0,3375,3375,16433
1999,60,i) 16 to 20,36083,43980,396664,392497,1615,3.6,3355,7.5,62435,21697,40738,5.5,15.9,53920,22711,31209,5.8,13.7,8515,2.2,27.4,0,2005,2005,8531
1999,60,j) 21 to 25,13801,24017,310323,311015,1220,5,2006,8.2,55118,18302,36816,5.9,17.7,57702,26238,31464,8.4,18.6,-2584,-0.9,35.4,0,691,691,2761
1999,60,l) Left Censored,69456,241904,4844537,4824504,26934,11.2,22815,9.5,849816,317832,531984,6.6,17.6,817266,343737,473529,7.1,16.9,32550,0.7,33.8,0,3132,3132,16259
1999,70,a) 0,191790,192642,1118575,559288,191152,198.5,0,0,1113234,1113234,0,199,199,0,0,0,0,0,1113234,199,0,0,,,
1999,70,b) 1,157921,159183,1215135,1195224,460,0.3,40619,22.5,355807,16424,339383,1.4,29.8,305509,178807,126702,15,25.6,50298,4.2,51.2,0,31180,31180,142141
1999,70,c) 2,134158,137218,1226044,1250774,3912,2.6,25972,17.5,295788,33938,261850,2.7,23.6,342132,194598,147534,15.6,27.4,-46344,-3.8,47.2,0,19879,19879,142669
1999,70,d) 3,114244,117184,1130290,1149620,3496,2.8,19141,15.3,216189,26303,189886,2.3,18.8,252000,126609,125391,11,21.9,-35811,-3.1,37.6,0,14622,14622,96906
1999,70,e) 4,101362,105130,1051556,1062692,3300,3,14621,13.2,200931,29111,171820,2.7,18.9,220619,103463,117156,9.7,20.8,-19688,-1.9,37.8,0,11000,11000,78784
1999,70,f) 5,88455,91601,962945,968541,2983,3.1,11591,12.1,188340,35514,152826,3.7,19.4,197696,88356,109340,9.1,20.4,-9356,-1,38.8,0,8778,8778,67285
1999,70,g) 6 to 10,342047,366580,4259196,4321029,11226,3,37903,10,666247,126758,539489,2.9,15.4,787786,321879,465907,7.4,18.2,-121539,-2.8,30.8,0,27122,27122,206040
1999,70,h) 11 to 15,286663,328686,5308710,5309764,10517,3.1,24856,7.4,691421,140220,551201,2.6,13,692551,232068,460483,4.4,13,-1130,0,26,0,15902,15902,114914
1999,70,i) 16 to 20,187503,223144,3663736,3670188,6502,2.9,15889,7,472003,106589,365414,2.9,12.9,480921,159912,321009,4.4,13.1,-8918,-0.2,25.8,0,9250,9250,64701
1999,70,j) 21 to 25,65771,104653,2292203,2295572,4398,4.2,6804,6.4,319587,81841,237746,3.6,13.9,325453,97218,228235,4.2,14.2,-5866,-0.3,27.8,0,3057,3057,17803
1999,70,l) Left Censored,297095,480604,16841476,16760078,24462,5.1,31383,6.5,2145685,591673,1554012,3.5,12.8,1988092,638928,1349164,3.8,11.9,157593,0.9,23.8,0,12600,12600,98725
2000,07,a) 0,10864,10869,43689,21845,10729,197.4,0,0,43301,,,,198.2,0,0,0,0,0,43301,198.2,0,1,,,
2000,07,b) 1,8365,8366,55958,47900,2,0,2173,22.8,27444,,,,57.3,11028,6649,4379,13.9,23,16416,34.3,46,1,1416,1416,4734
2000,07,c) 2,7012,7012,39274,38695,240,3.2,1242,16.5,9702,912,8790,2.4,25.1,8648,4068,4580,10.5,22.3,1054,2.8,44.6,0,862,862,2910
2000,07,d) 3,6294,6295,34709,34867,202,3,912,13.7,7562,605,6957,1.7,21.7,7787,3486,4301,10,22.3,-225,-0.6,43.4,0,624,624,2612
2000,07,e) 4,5434,5536,38019,37061,190,3.3,772,13.3,8943,1135,7808,3.1,24.1,7051,3381,3670,9.1,19,1892,5.1,38,0,541,541,2435
2000,07,f) 5,5219,5277,33619,33627,201,3.7,637,11.6,7198,860,6338,2.6,21.4,7221,2675,4546,8,21.5,-23,-0.1,42.8,0,433,433,1834
2000,07,g) 6 to 10,19275,19607,160173,159376,621,3.1,2046,10.1,30668,4226,26442,2.7,19.2,29178,12291,16887,7.7,18.3,1490,0.9,36.6,0,1337,1337,8487
2000,07,h) 11 to 15,14270,14301,128223,128301,359,2.4,1188,8.1,20422,1661,18761,1.3,15.9,20514,7582,12932,5.9,16,-92,-0.1,31.8,0,780,780,5530
2000,07,i) 16 to 20,8193,8318,91267,91048,168,2,573,6.7,13163,869,12294,1,14.5,12924,3945,8979,4.3,14.2,239,0.3,28.4,0,397,397,3073
2000,07,j) 21 to 25,3888,3987,40199,40729,114,2.8,258,6.4,5657,1044,4613,2.6,13.9,6659,2387,4272,5.9,16.3,-1002,-2.4,27.8,0,178,178,1890
2000,07,l) Left Censored,7098,8181,157553,157100,205,2.4,714,8.5,30027,12184,17843,7.8,19.1,28517,11417,17100,7.3,18.2,1510,0.9,36.4,0,375,375,3490
2000,10,a) 0,1290,1291,8624,4312,1273,197.2,0,0,8538,,,,198,0,0,0,0,0,8538,198,0,1,,,
2000,10,b) 1,924,929,7437,7711,1,0.1,243,22.9,2001,,,,25.9,2502,1754,748,22.7,32.4,-501,-6.5,51.8,1,193,193,1306
2000,10,c) 2,873,875,7769,8027,28,2.9,216,22.4,2032,471,1561,5.9,25.3,2564,1474,1090,18.4,31.9,-532,-6.6,50.6,0,167,167,1257
2000,10,d) 3,859,886,7420,7637,38,4,138,14.7,1876,292,1584,3.8,24.6,2291,1001,1290,13.1,30,-415,-5.4,49.2,0,101,101,830
2000,10,e) 4,668,697,6583,6938,31,4.2,126,16.9,1695,777,918,11.2,24.4,2295,1154,1141,16.6,33.1,-600,-8.7,48.8,0,90,90,893
2000,10,f) 5,640,641,5954,5984,17,2.5,90,13.3,1112,90,1022,1.5,18.6,1141,537,604,9,19.1,-29,-0.5,37.2,0,67,67,449
2000,10,g) 6 to 10,2767,3023,33721,33950,113,3.6,333,10.6,5471,848,4623,2.5,16.1,5805,1789,4016,5.3,17.1,-334,-1,32.2,0,247,247,1281
2000,10,h) 11 to 15,2295,2426,27386,27626,107,4.3,243,9.8,4106,837,3269,3,14.9,4649,1688,2961,6.1,16.8,-543,-1.9,29.8,0,162,162,839
2000,10,i) 16 to 20,2232,2470,35633,35982,80,3.1,227,8.9,5262,985,4277,2.7,14.6,6086,1974,4112,5.5,16.9,-824,-2.3,29.2,0,146,146,819
2000,10,j) 21 to 25,906,1441,27080,28059,52,3.5,106,7.2,3769,459,3310,1.6,13.4,5745,1329,4416,4.7,20.5,-1976,-7.1,26.8,0,58,58,407
2000,10,l) Left Censored,3129,6883,300716,306958,388,5.6,515,7.4,43244,8880,34364,2.9,14.1,54887,13723,41164,4.5,17.9,-11643,-3.8,28.2,0,141,141,1500
2000,15,a) 0,61212,61224,274860,137430,60517,197.7,0,0,272262,272262,0,198.1,198.1,0,0,0,0,0,272262,198.1,0,0,,,
2000,15,b) 1,48378,48391,287450,287339,8,0,15602,27.5,94277,72,94205,0,32.8,91607,55012,36595,19.1,31.9,2670,0.9,63.8,0,11102,11102,41357
2000,15,c) 2,41747,41767,273812,279156,1431,3.1,8689,19.1,71477,5754,65723,2.1,25.6,81589,40098,41491,14.4,29.2,-10112,-3.6,51.2,0,6287,6287,31283
2000,15,d) 3,37371,37435,269363,273469,1481,3.7,6463,16.2,62504,6409,56095,2.3,22.9,71158,29717,41441,10.9,26,-8654,-3.1,45.8,0,4534,4534,21846
2000,15,e) 4,33145,33158,250454,251344,1185,3.4,4972,14.2,57907,5369,52538,2.1,23,60160,24873,35287,9.9,23.9,-2253,-0.9,46,0,3523,3523,19136
2000,15,f) 5,31405,31410,249090,250555,1139,3.4,4442,13.5,53044,4521,48523,1.8,21.2,56381,21915,34466,8.7,22.5,-3337,-1.3,42.4,0,3143,3143,16953
2000,15,g) 6 to 10,110083,110277,1058957,1046350,3793,3.3,12854,11.2,227795,18070,209725,1.7,21.8,203895,68415,135480,6.5,19.5,23900,2.3,39,0,8702,8702,51231
2000,15,h) 11 to 15,83441,83738,910950,907538,2710,3.1,7733,9,154326,11754,142572,1.3,17,148240,42132,106108,4.6,16.3,6086,0.7,32.6,0,5178,5178,30536
2000,15,i) 16 to 20,46873,47600,698551,692739,1286,2.6,3885,7.9,113362,10377,102985,1.5,16.4,101026,24233,76793,3.5,14.6,12336,1.8,29.2,0,2597,2597,15683
2000,15,j) 21 to 25,26587,26947,370591,366095,791,2.9,2386,8.6,60168,7889,52279,2.2,16.4,51466,12909,38557,3.5,14.1,8702,2.3,28.2,0,1653,1653,9422
2000,15,l) Left Censored,56180,61430,1688174,1656462,1315,2.1,4515,7.2,274214,26364,247850,1.6,16.6,208469,45988,162481,2.8,12.6,65745,4,25.2,0,3051,3051,20007
2000,20,a) 0,21495,21568,212689,106345,21413,198.6,0,0,211975,211975,0,199.3,199.3,0,0,0,0,0,211975,199.3,0,0,,,
2000,20,b) 1,17228,17417,221644,219598,78,0.4,4629,23.4,64160,8732,55428,4,29.2,59110,37885,21225,17.3,26.9,5050,2.3,53.8,0,3628,3628,31182
2000,20,c) 2,15880,15929,197671,204916,393,2.3,3311,19,43221,4403,38818,2.1,21.1,57641,35884,21757,17.5,28.1,-14420,-7,42.2,0,2667,2667,29948
2000,20,d) 3,14277,14423,221585,222509,392,2.5,2492,16.1,41386,5403,35983,2.4,18.6,42905,23468,19437,10.5,19.3,-1519,-0.7,37.2,0,2005,2005,19280
2000,20,e) 4,12745,12918,186556,189287,272,2,1937,14.1,31257,2155,29102,1.1,16.5,36366,18618,17748,9.8,19.2,-5109,-2.7,33,0,1496,1496,13711
2000,20,f) 5,12129,12259,194230,197005,249,1.9,1657,12.8,30792,2495,28297,1.3,15.6,36101,17026,19075,8.6,18.3,-5309,-2.7,31.2,0,1311,1311,13097
2000,20,g) 6 to 10,47966,49304,928152,939352,973,1.9,5357,10.4,128503,12762,115741,1.4,13.7,151672,59335,92337,6.3,16.1,-23169,-2.4,27.4,0,4070,4070,38831
2000,20,h) 11 to 15,40309,42507,1260703,1266293,838,1.9,3511,8,151089,25092,125997,2,11.9,163132,54263,108869,4.3,12.9,-12043,-1,23.8,0,2558,2558,30005
2000,20,i) 16 to 20,29559,33376,1304697,1308659,617,1.8,2344,6.8,149229,28309,120920,2.2,11.4,157181,55675,101506,4.3,12,-7952,-0.6,22.8,0,1537,1537,18424
2000,20,j) 21 to 25,16055,19087,912828,922707,371,1.9,1291,6.6,87304,16547,70757,1.8,9.5,106219,30228,75991,3.3,11.5,-18915,-2,19,0,790,790,9021
2000,20,l) Left Censored,64102,114453,12640820,12757036,3880,3.3,6702,5.8,1103166,237090,866076,1.9,8.6,1338838,389664,949174,3.1,10.5,-235672,-1.9,17.2,0,2383,2383,41560
2000,40,a) 0,23721,23848,128853,64427,23636,198.2,0,0,128102,128102,0,198.8,198.8,0,0,0,0,0,128102,198.8,0,0,,,
2000,40,b) 1,18330,18741,155369,150290,233,1.1,6516,29.6,52120,6534,45586,4.3,34.7,41058,24326,16732,16.2,27.3,11062,7.4,54.6,0,5089,5089,19620
2000,40,c) 2,14900,15200,132315,130917,431,2.6,3803,22.5,36782,4193,32589,3.2,28.1,33962,19964,13998,15.2,25.9,2820,2.2,51.8,0,3023,3023,16433
2000,40,d) 3,12889,13246,118590,121372,402,2.8,2796,19.4,25023,3043,21980,2.5,20.6,30315,16102,14213,13.3,25,-5292,-4.4,41.2,0,2083,2083,12153
2000,40,e) 4,11509,11799,107955,109884,386,3,2161,17,22835,2548,20287,2.3,20.8,26411,14195,12216,12.9,24,-3576,-3.2,41.6,0,1641,1641,10497
2000,40,f) 5,10346,10951,97514,98406,395,3.4,1768,15.2,18097,2662,15435,2.7,18.4,20068,10194,9874,10.4,20.4,-1971,-2,36.8,0,1325,1325,7266
2000,40,g) 6 to 10,34623,37977,476963,478405,1180,3,4986,12.5,89362,16321,73041,3.4,18.7,89601,41507,48094,8.7,18.7,-239,0,37.4,0,3581,3581,23815
2000,40,h) 11 to 15,23008,32724,661388,648254,2369,7.2,3204,9.7,122970,44481,78489,6.9,19,99516,38517,60999,5.9,15.4,23454,3.6,30.8,0,1894,1894,14869
2000,40,i) 16 to 20,13602,23377,604508,602596,1114,4.7,1695,7.2,80576,25003,55573,4.1,13.4,76706,27576,49130,4.6,12.7,3870,0.7,25.4,0,1012,1012,10644
2000,40,j) 21 to 25,6781,14903,470850,446676,929,6.1,1393,9.2,97666,20565,77101,4.6,21.9,49265,20462,28803,4.6,11,48401,10.9,22,0,453,453,2884
2000,40,l) Left Censored,20617,77080,3800949,3768376,8431,10.9,8959,11.6,526558,209715,316843,5.6,14,464051,185499,278552,4.9,12.3,62507,1.7,24.6,0,1065,1065,13017
2000,50,a) 0,26912,27055,138120,69060,26847,198.5,0,0,137324,137324,0,198.8,198.8,0,0,0,0,0,137324,198.8,0,0,,,
2000,50,b) 1,22066,22227,135048,132822,58,0.2,5794,23,39461,1863,37598,1.4,29.7,34335,22200,12135,16.7,25.9,5126,3.8,51.8,0,4512,4512,17789
2000,50,c) 2,19729,19793,127520,128380,455,2.1,3855,17.9,27980,2751,25229,2.1,21.8,29578,16860,12718,13.1,23,-1598,-1.2,43.6,0,3068,3068,13940
2000,50,d) 3,18995,19406,132807,134076,507,2.4,3305,15.9,26958,2601,24357,1.9,20.1,29896,16252,13644,12.1,22.3,-2938,-2.2,40.2,0,2588,2588,13444
2000,50,e) 4,18543,18910,138088,138384,489,2.4,2719,13.6,24747,2230,22517,1.6,17.9,25712,12618,13094,9.1,18.6,-965,-0.7,35.8,0,2088,2088,9787
2000,50,f) 5,16539,16896,129824,130243,385,2.2,2360,13.2,23246,2528,20718,1.9,17.8,24221,12313,11908,9.5,18.6,-975,-0.8,35.6,0,1822,1822,9503
2000,50,g) 6 to 10,64260,67410,628892,641866,1465,2.1,7246,10.3,95005,10306,84699,1.6,14.8,121693,64850,56843,10.1,19,-26688,-4.2,29.6,0,5368,5368,51946
2000,50,h) 11 to 15,49504,56311,710139,713922,1151,2,4706,8.1,95421,13819,81602,1.9,13.4,103153,40889,62264,5.7,14.4,-7732,-1,26.8,0,2996,2996,21387
2000,50,i) 16 to 20,35612,44764,674417,678898,1166,2.5,3329,7.3,90525,20733,69792,3.1,13.3,98636,37065,61571,5.5,14.5,-8111,-1.2,26.6,0,1941,1941,14886
2000,50,j) 21 to 25,18542,27731,481925,482135,838,3,1949,6.9,57862,13397,44465,2.8,12,58210,19602,38608,4.1,12.1,-348,-0.1,24,0,865,865,6788
2000,50,l) Left Censored,63965,149862,3733319,3738532,7190,4.7,12123,8,506706,144775,361931,3.9,13.6,517085,209930,307155,5.6,13.8,-10379,-0.2,27.2,0,2690,2690,27812
2000,52,a) 0,103444,104661,772012,386006,104020,198.8,0,0,769515,769515,0,199.4,199.4,0,0,0,0,0,769515,199.4,0,0,,,
2000,52,b) 1,79645,81524,704075,734124,647,0.7,23489,25.2,169370,22589,146781,3.1,23.1,226880,130949,95931,17.8,30.9,-57510,-7.8,46.2,0,18950,18950,107664
2000,52,c) 2,67979,69370,617877,644268,1865,2.4,15355,20.2,112191,13849,98342,2.1,17.4,164434,89893,74541,14,25.5,-52243,-8.1,34.8,0,12469,12469,72373
2000,52,d) 3,60607,64249,588433,607554,2062,3,12107,17.5,99457,19186,80271,3.2,16.4,138012,75067,62945,12.4,22.7,-38555,-6.3,32.8,0,9672,9672,57575
2000,52,e) 4,53316,56481,534504,551525,1563,2.6,9268,15.4,81906,12926,68980,2.3,14.9,116429,58785,57644,10.7,21.1,-34523,-6.2,29.8,0,7194,7194,45553
2000,52,f) 5,46672,50093,481361,493452,1526,2.9,7463,14.1,72961,11021,61940,2.2,14.8,97070,49738,47332,10.1,19.7,-24109,-4.9,29.6,0,5761,5761,36965
2000,52,g) 6 to 10,170369,190114,2071986,2108619,5299,2.7,24233,12.2,290977,57477,233500,2.7,13.8,364940,168851,196089,8,17.3,-73963,-3.5,27.6,0,17769,17769,113795
2000,52,h) 11 to 15,119988,153704,2030334,2064997,4899,3.1,15501,9.8,266541,72187,194354,3.5,12.9,335921,144707,191214,7,16.3,-69380,-3.4,25.8,0,9803,9803,66842
2000,52,i) 16 to 20,78169,112235,1677137,1682558,3488,3,9381,8.1,221900,70250,151650,4.2,13.2,232397,84964,147433,5,13.8,-10497,-0.6,26.4,0,5529,5529,38904
2000,52,j) 21 to 25,42379,82199,1602990,1573642,3649,4.4,6188,7.4,248269,103944,144325,6.6,15.8,189604,63260,126344,4,12,58665,3.8,24,0,2741,2741,18931
2000,52,l) Left Censored,111086,449677,11947962,11884195,25479,5.6,29952,6.6,1532585,541279,991306,4.6,12.9,1408632,488945,919687,4.1,11.9,123953,1,23.8,0,6888,6901,49038
2000,60,a) 0,40628,40783,176853,88427,40442,198.3,0,0,175897,175897,0,198.9,198.9,0,0,0,0,0,175897,198.9,0,0,,,
2000,60,b) 1,32599,32839,174850,178486,108,0.3,8862,23.7,48912,2428,46484,1.4,27.4,55045,36089,18956,20.2,30.8,-6133,-3.4,54.8,0,6481,6481,27672
2000,60,c) 2,26918,27356,142989,148824,763,2.6,5229,17.6,31240,3785,27455,2.5,21,42175,24308,17867,16.3,28.3,-10935,-7.3,42,0,3894,3894,19152
2000,60,d) 3,23807,24952,145052,149553,758,2.9,4033,15.2,25226,5482,19744,3.7,16.9,34106,17638,16468,11.8,22.8,-8880,-5.9,33.8,0,2847,2847,12582
2000,60,e) 4,20570,21394,128420,131312,596,2.6,3128,13.8,22163,2635,19528,2,16.9,28241,13537,14704,10.3,21.5,-6078,-4.6,33.8,0,2257,2257,9218
2000,60,f) 5,18429,20062,142604,144036,719,3.4,2958,14,29256,5177,24079,3.6,20.3,32391,14275,18116,9.9,22.5,-3135,-2.2,40.6,0,1800,1800,8834
2000,60,g) 6 to 10,69513,76576,555303,562875,2414,3,8503,10.7,86814,18285,68529,3.2,15.4,102257,43492,58765,7.7,18.2,-15443,-2.8,30.8,0,5391,5391,24578
2000,60,h) 11 to 15,52885,60997,477771,481498,2125,3.4,5424,8.7,70564,18009,52555,3.7,14.7,76999,30229,46770,6.3,16,-6435,-1.3,29.4,0,3320,3320,13816
2000,60,i) 16 to 20,36401,46642,428174,431107,1681,3.5,3669,7.7,54397,12198,42199,2.8,12.6,60730,24031,36699,5.6,14.1,-6333,-1.5,25.2,0,2003,2003,9681
2000,60,j) 21 to 25,19579,30729,370084,372637,1341,4.3,2670,8.5,53572,18064,35508,4.8,14.4,59268,20568,38700,5.5,15.9,-5696,-1.5,28.8,0,1026,1026,3385
2000,60,l) Left Censored,66052,241377,4841150,4851301,24902,10.3,26022,10.8,813784,311127,502657,6.4,16.8,841409,302201,539208,6.2,17.3,-27625,-0.5,33.6,0,2819,2819,13097
2000,70,a) 0,187311,188547,1125282,562641,187033,198.4,0,0,1120861,1120861,0,199.2,199.2,0,0,0,0,0,1120861,199.2,0,0,,,
2000,70,b) 1,150270,151311,1259939,1189881,263,0.2,39501,23,433757,21907,411850,1.8,36.5,287119,167250,119869,14.1,24.1,146638,12.4,48.2,0,28699,28699,129049
2000,70,c) 2,135297,136719,1208847,1196971,3935,2.7,26083,17.6,307628,30403,277225,2.5,25.7,282449,157850,124599,13.2,23.6,25179,2.1,47.2,0,19368,19368,126340
2000,70,d) 3,118050,121564,1220304,1219625,4133,3.2,19796,15.3,268383,37296,231087,3.1,22,266547,145411,121136,11.9,21.9,1836,0.1,43.8,0,14614,14614,112206
2000,70,e) 4,102225,105236,1134760,1128677,3262,2.9,15332,13.8,216989,26377,190612,2.3,19.2,205704,99819,105885,8.8,18.2,11285,1,36.4,0,11037,11037,70717
2000,70,f) 5,91706,95688,1065677,1058053,3015,3,12729,12.7,214031,21378,192653,2,20.2,201678,90833,110845,8.6,19.1,12353,1.1,38.2,0,8996,8996,61543
2000,70,g) 6 to 10,342667,365650,4432917,4428843,10131,2.7,38728,10.2,749335,133905,615430,3,16.9,743752,306642,437110,6.9,16.8,5583,0.1,33.6,0,26562,26562,193270
2000,70,h) 11 to 15,262155,301749,5313804,5277647,10235,3.3,25322,8.2,739065,173265,565800,3.3,14,670356,235783,434573,4.5,12.7,68709,1.3,25.4,0,15197,15197,104623
2000,70,i) 16 to 20,211499,248175,3841197,3853605,6894,2.7,17977,7.1,510923,113961,396962,3,13.3,527286,206311,320975,5.4,13.7,-16363,-0.4,26.6,0,9474,9474,70730
2000,70,j) 21 to 25,94037,140537,2943463,2929739,5595,3.9,9019,6.3,384488,105931,278557,3.6,13.1,359697,106058,253639,3.6,12.3,24791,0.8,24.6,0,4132,4132,24557
2000,70,l) Left Censored,283317,472502,17369295,17150059,22899,4.8,32320,6.8,2359225,678381,1680844,4,13.8,1924958,642417,1282541,3.7,11.2,434267,2.6,22.4,0,11620,11620,95157
2001,07,a) 0,10411,10448,42568,21284,10309,197.3,0,0,42207,42207,0,198.3,198.3,0,0,0,0,0,42207,198.3,0,0,,,
2001,07,b) 1,8617,8624,43702,43731,3,0,2267,23.2,11701,,,,26.8,11759,5996,5763,13.7,26.9,-58,-0.1,53.6,1,1331,1331,3784
2001,07,c) 2,7187,7188,37851,39324,211,2.7,1408,18.1,8025,760,7265,1.9,20.4,11200,5603,5597,14.2,28.5,-3175,-8.1,40.8,0,888,888,3279
2001,07,d) 3,6194,6194,36834,37982,196,3,1049,15.9,6953,,,,18.3,9388,4145,5243,10.9,24.7,-2435,-6.4,36.6,1,655,655,2940
2001,07,e) 4,5681,5684,33024,33848,194,3.2,842,14.1,5687,692,4995,2,16.8,7510,2960,4550,8.7,22.2,-1823,-5.4,33.6,0,522,522,1799
2001,07,f) 5,5012,5112,35707,36859,158,3,636,11.9,5750,580,5170,1.6,15.6,8438,4060,4378,11,22.9,-2688,-7.3,31.2,0,400,400,2905
2001,07,g) 6 to 10,19132,19563,162049,159388,616,3,2162,10.7,34848,3661,31187,2.3,21.9,30204,11174,19030,7,18.9,4644,3,37.8,0,1336,1336,7496
2001,07,h) 11 to 15,14900,14933,140676,140950,367,2.4,1345,8.7,22091,1665,20426,1.2,15.7,23058,7568,15490,5.4,16.4,-967,-0.7,31.4,0,795,795,4300
2001,07,i) 16 to 20,8764,8882,95145,96799,156,1.7,641,7,11003,1018,9985,1.1,11.4,14569,4636,9933,4.8,15.1,-3566,-3.7,22.8,0,391,391,2760
2001,07,j) 21 to 25,4983,5099,54403,54814,78,1.5,354,6.8,6637,389,6248,0.7,12.1,7488,2713,4775,4.9,13.7,-851,-1.6,24.2,0,230,230,1437
2001,07,l) Left Censored,10696,12058,293154,288536,1426,12,1203,10.2,100882,41631,59251,14.4,35,95972,24420,71552,8.5,33.3,4910,1.7,66.6,0,369,369,2229
2001,10,a) 0,1444,1449,9757,4879,1435,198.1,0,0,9474,9474,0,194.2,194.2,0,0,0,0,0,9474,194.2,0,0,,,
2001,10,b) 1,1001,1003,8046,8320,3,0.3,291,25.4,2597,,,,31.2,3145,2207,938,26.5,37.8,-548,-6.6,62.4,1,198,198,1714
2001,10,c) 2,794,799,7828,7612,16,1.9,151,17.5,2065,166,1899,2.2,27.1,1719,993,726,13,22.6,346,4.5,45.2,0,124,124,872
2001,10,d) 3,757,760,9100,8388,16,2,135,16.5,2860,,,,34.1,1530,948,582,11.3,18.2,1330,15.9,36.4,1,100,100,679
2001,10,e) 4,771,798,8748,8280,28,3.3,129,15.3,2525,817,1708,9.9,30.5,1640,635,1005,7.7,19.8,885,10.7,39.6,0,92,92,489
2001,10,f) 5,631,656,6618,6601,28,4.1,80,11.8,1050,144,906,2.2,15.9,1069,578,491,8.8,16.2,-19,-0.3,31.8,0,53,53,367
2001,10,g) 6 to 10,2750,3001,32907,32986,111,3.6,277,9,5449,740,4709,2.2,16.5,5919,2091,3828,6.3,17.9,-470,-1.4,33,0,184,184,1577
2001,10,h) 11 to 15,2211,2333,30552,29975,81,3.4,245,10.2,6188,697,5491,2.3,20.6,5376,1944,3432,6.5,17.9,812,2.7,35.8,0,162,162,1178
2001,10,i) 16 to 20,2287,2470,36143,35807,90,3.6,230,9.1,5828,712,5116,2,16.3,5290,2548,2742,7.1,14.8,538,1.5,29.6,0,118,118,1229
2001,10,j) 21 to 25,1164,1733,34232,33290,45,2.5,138,7.8,5545,836,4709,2.5,16.7,3705,1037,2668,3.1,11.1,1840,5.6,22.2,0,76,76,518
2001,10,l) Left Censored,3107,6895,304909,302746,360,5.2,520,7.5,43642,10259,33383,3.4,14.4,39820,11723,28097,3.9,13.2,3822,1.2,26.4,0,113,113,630
2001,15,a) 0,57332,57357,263951,131976,56625,197.4,0,0,261525,261525,0,198.2,198.2,0,0,0,0,0,261525,198.2,0,0,,,
2001,15,b) 1,45634,45689,273102,275505,33,0.1,15588,29.2,84714,4188,80526,1.5,30.7,89519,52759,36760,19.1,32.5,-4805,-1.8,61.4,0,10317,10317,37171
2001,15,c) 2,40585,40607,254939,269660,1454,3.3,9614,21.6,59873,6031,53842,2.2,22.2,90609,46985,43624,17.4,33.6,-30736,-11.4,44.4,0,6454,6454,35703
2001,15,d) 3,36527,36549,250359,262513,1319,3.4,6948,17.7,51551,5964,45587,2.3,19.6,78195,33694,44501,12.8,29.8,-26644,-10.2,39.2,0,4678,4678,25612
2001,15,e) 4,33256,33297,255149,261949,1192,3.4,5702,16.1,52092,5488,46604,2.1,19.9,67827,27498,40329,10.5,25.9,-15735,-6,39.8,0,3738,3738,18532
2001,15,f) 5,29910,29921,233540,241174,1022,3.2,4584,14.5,44574,4393,40181,1.8,18.5,61302,22590,38712,9.4,25.4,-16728,-6.9,37,0,3013,3013,16648
2001,15,g) 6 to 10,111349,111588,1027280,1059459,3596,3.1,14228,12.2,168571,16031,152540,1.5,15.9,237345,78117,159228,7.4,22.4,-68774,-6.5,31.8,0,8854,8854,52883
2001,15,h) 11 to 15,84062,84256,901986,919727,2617,3,8813,10.1,134458,11074,123384,1.2,14.6,174056,53412,120644,5.8,18.9,-39598,-4.3,29.2,0,5372,5372,31263
2001,15,i) 16 to 20,49175,49751,737241,743728,1275,2.5,4418,8.6,108416,6945,101471,0.9,14.6,124109,33077,91032,4.4,16.7,-15693,-2.1,29.2,0,2687,2687,18677
2001,15,j) 21 to 25,33701,34411,491797,497991,958,2.7,3096,8.8,68963,10257,58706,2.1,13.8,82277,19489,62788,3.9,16.5,-13314,-2.7,27.6,0,1939,1939,10603
2001,15,l) Left Censored,53413,58861,1687273,1691325,1298,2.2,4530,7.5,249363,34510,214853,2,14.7,261678,60261,201417,3.6,15.5,-12315,-0.8,29.4,0,2866,2868,21141
2001,20,a) 0,19838,19903,185780,92890,19706,198,0,0,182068,182068,0,196,196,0,0,0,0,0,182068,196,0,0,,,
2001,20,b) 1,16990,17122,205805,205915,86,0.4,4512,23.3,58240,6684,51556,3.2,28.3,59459,35067,24392,17,28.9,-1219,-0.6,56.6,0,3350,3351,27844
2001,20,c) 2,14656,14860,196751,208187,383,2.4,2989,18.6,36499,3877,32622,1.9,17.5,60237,32060,28177,15.4,28.9,-23738,-11.4,35,0,2345,2345,27143
2001,20,d) 3,13755,13802,181977,188255,352,2.4,2557,17.2,31887,2460,29427,1.3,16.9,45627,22454,23173,11.9,24.2,-13740,-7.3,33.8,0,1990,1990,18142
2001,20,e) 4,12688,12855,208654,213266,318,2.3,1972,14.5,37220,3295,33925,1.5,17.5,47241,22285,24956,10.4,22.2,-10021,-4.7,35,0,1497,1497,15617
2001,20,f) 5,11455,11637,174899,181121,297,2.4,1668,13.6,24213,2963,21250,1.6,13.4,37345,15697,21648,8.7,20.6,-13132,-7.2,26.8,0,1307,1307,12075
2001,20,g) 6 to 10,46732,47971,857933,886710,1063,2.1,5674,11.3,105665,18223,87442,2.1,11.9,167253,64478,102775,7.3,18.9,-61588,-7,23.8,0,4114,4114,43218
2001,20,h) 11 to 15,38912,40814,1120759,1139634,752,1.8,3581,8.5,125607,26906,98701,2.4,11,167615,51462,116153,4.5,14.7,-42008,-3.7,22,0,2512,2512,28439
2001,20,i) 16 to 20,30302,33881,1335162,1355240,706,2,2380,6.9,130758,28340,102418,2.1,9.6,173815,45412,128403,3.4,12.8,-43057,-3.2,19.2,0,1502,1502,19640
2001,20,j) 21 to 25,20401,24393,1105706,1122006,483,1.9,1585,6.4,97761,19423,78338,1.7,8.7,132960,32232,100728,2.9,11.9,-35199,-3.2,17.4,0,959,959,11009
2001,20,l) Left Censored,61925,111895,12191554,12432296,3312,2.9,6771,6,926411,192465,733946,1.5,7.5,1422731,341678,1081053,2.7,11.4,-496320,-3.9,15,0,2271,2272,33083
2001,40,a) 0,22337,22542,119881,59941,22340,198.2,0,0,118997,118997,0,198.5,198.5,0,0,0,0,0,118997,198.5,0,0,,,
2001,40,b) 1,17528,17671,138419,132945,96,0.5,6274,30.2,52194,6710,45484,5,39.3,41245,25461,15784,19.2,31,10949,8.3,62,0,4648,4649,20873
2001,40,c) 2,14919,15360,145092,148701,545,3.2,4054,23.8,32258,3159,29099,2.1,21.7,39889,22915,16974,15.4,26.8,-7631,-5.1,43.4,0,3082,3082,16499
2001,40,d) 3,12573,13207,121484,125775,788,5.6,2897,20.4,31194,10499,20695,8.3,24.8,40340,23409,16931,18.6,32.1,-9146,-7.3,49.6,0,2208,2208,17690
2001,40,e) 4,11126,11530,113710,115169,397,3.2,2238,18.1,24319,4679,19640,4.1,21.1,28040,14919,13121,13,24.3,-3721,-3.2,42.2,0,1679,1679,11548
2001,40,f) 5,10056,10399,106225,108977,336,3,1907,17.1,20275,1625,18650,1.5,18.6,26681,14636,12045,13.4,24.5,-6406,-5.9,37.2,0,1387,1387,10545
2001,40,g) 6 to 10,35363,38416,453369,468677,1421,3.5,5573,13.8,72315,14123,58192,3,15.4,105190,50613,54577,10.8,22.4,-32875,-7,30.8,0,3679,3679,24183
2001,40,h) 11 to 15,23073,30553,557135,566754,1397,4.4,4292,13.5,93523,23784,69739,4.2,16.5,117574,56316,61258,9.9,20.7,-24051,-4.2,33,0,1849,1849,15367
2001,40,i) 16 to 20,13993,32328,780318,753625,7167,23.9,2640,8.8,167275,110884,56391,14.7,22.2,115495,48371,67124,6.4,15.3,51780,6.9,30.6,0,961,965,8547
2001,40,j) 21 to 25,8611,18174,530853,535111,1500,8.3,1438,7.9,74025,22216,51809,4.2,13.8,83049,28577,54472,5.3,15.5,-9024,-1.7,27.6,0,511,511,4221
2001,40,l) Left Censored,20372,78192,3759075,3777144,8183,10.6,6724,8.7,451653,183772,267881,4.9,12,495849,117769,378080,3.1,13.1,-44196,-1.1,24,0,867,868,7830
2001,50,a) 0,24646,24959,126642,63321,24758,198.4,0,0,125835,125835,0,198.7,198.7,0,0,0,0,0,125835,198.7,0,0,,,
2001,50,b) 1,20916,21137,148780,143353,91,0.4,6026,25,49677,14000,35677,9.8,34.7,39055,23478,15577,16.4,27.2,10622,7.5,54.4,0,4461,4465,18282
2001,50,c) 2,18721,18984,129981,132503,534,2.6,3903,18.9,29127,6234,22893,4.7,22,34539,19569,14970,14.8,26.1,-5412,-4.1,44,0,3014,3014,16616
2001,50,d) 3,17245,17307,120387,123532,443,2.4,3053,16.5,21954,2637,19317,2.1,17.8,28699,14219,14480,11.5,23.2,-6745,-5.4,35.6,0,2273,2273,11191
2001,50,e) 4,16793,17202,126458,129578,483,2.6,2810,15.4,21938,2282,19656,1.8,16.9,28668,14262,14406,11,22.1,-6730,-5.2,33.8,0,2038,2038,11180
2001,50,f) 5,16620,16971,137664,137703,437,2.4,2468,13.8,26578,2623,23955,1.9,19.3,27150,13008,14142,9.4,19.7,-572,-0.4,38.6,0,1803,1803,8964
2001,50,g) 6 to 10,63255,66030,599468,612515,1501,2.2,7777,11.3,85764,14837,70927,2.4,14,114469,46228,68241,7.5,18.7,-28705,-4.7,28,0,5501,5501,31802
2001,50,h) 11 to 15,48302,54031,661297,675722,1229,2.2,4927,8.8,76569,14632,61937,2.2,11.3,107508,40539,66969,6,15.9,-30939,-4.6,22.6,0,3071,3071,21567
2001,50,i) 16 to 20,36661,46549,715633,718487,1652,3.5,3694,7.8,88861,23606,65255,3.3,12.4,97045,33024,64021,4.6,13.5,-8184,-1.1,24.8,0,2020,2026,15172
2001,50,j) 21 to 25,23247,33555,569231,574038,1006,2.9,2575,7.5,68571,15180,53391,2.6,11.9,78956,28917,50039,5,13.8,-10385,-1.9,23.8,0,1167,1178,7913
2001,50,l) Left Censored,61896,149413,3749577,3759579,9121,6.1,11277,7.5,509441,163703,345738,4.4,13.6,537443,169134,368309,4.5,14.3,-28002,-0.7,27.2,0,2477,2488,24172
2001,52,a) 0,102487,103612,724393,362197,102912,198.6,0,0,720479,720479,0,198.9,198.9,0,0,0,0,0,720479,198.9,0,0,,,
2001,52,b) 1,79546,81131,679841,724441,443,0.5,23958,25.8,151047,15002,136045,2.1,20.9,240247,129929,110318,17.9,33.2,-89200,-12.3,41.8,0,18383,18411,104352
2001,52,c) 2,66190,68202,622352,662725,1856,2.5,15613,20.9,100996,14822,86174,2.2,15.2,184196,101084,83112,15.3,27.8,-83200,-12.6,30.4,0,12184,12184,79968
2001,52,d) 3,58452,59951,552502,583088,1807,2.8,11652,18,80763,13754,67009,2.4,13.9,144419,75361,69058,12.9,24.8,-63656,-10.9,27.8,0,9140,9140,58649
2001,52,e) 4,53087,56799,543314,565573,1637,2.7,9627,15.9,76381,13645,62736,2.4,13.5,123485,59535,63950,10.5,21.8,-47104,-8.3,27,0,7330,7330,44784
2001,52,f) 5,47173,50308,490887,510374,1517,2.8,7992,15,65787,12195,53592,2.4,12.9,107597,51992,55605,10.2,21.1,-41810,-8.2,25.8,0,6041,6041,38693
2001,52,g) 6 to 10,169284,188813,2048221,2109111,5987,3,25358,12.8,264236,61193,203043,2.9,12.5,396050,179664,216386,8.5,18.8,-131814,-6.3,25,0,17956,17957,118820
2001,52,h) 11 to 15,117758,150290,1968309,2002126,5174,3.3,15702,10.1,242823,67492,175331,3.4,12.1,315997,117726,198271,5.9,15.8,-73174,-3.7,24.2,0,9811,9812,64012
2001,52,i) 16 to 20,79982,112354,1726500,1753627,3529,3,10967,9.5,200731,62318,138413,3.6,11.4,258826,92474,166352,5.3,14.8,-58095,-3.4,22.8,0,5710,5724,41204
2001,52,j) 21 to 25,52169,99105,1883596,1887793,4173,4.1,7681,7.6,242439,98768,143671,5.2,12.8,254175,80866,173309,4.3,13.5,-11736,-0.7,25.6,0,3283,3306,21010
2001,52,l) Left Censored,105414,444819,11847293,11902690,22420,5,29388,6.6,1405836,506584,899252,4.3,11.8,1533282,465649,1067633,3.9,12.9,-127446,-1.1,23.6,0,6243,6312,47222
2001,60,a) 0,41759,41989,184100,92050,41618,198.2,0,0,182640,182640,0,198.4,198.4,0,0,0,0,0,182640,198.4,0,0,,,
2001,60,b) 1,31875,32051,167802,170711,91,0.3,8768,24.1,47659,3760,43899,2.2,27.9,53477,33886,19591,19.8,31.3,-5818,-3.4,55.8,0,5964,5970,25904
2001,60,c) 2,27909,28184,154101,164300,830,2.7,5645,18.5,30518,3821,26697,2.3,18.6,51599,31397,20202,19.1,31.4,-21081,-12.8,37.2,0,3996,3996,22157
2001,60,d) 3,23712,24188,134909,138087,764,3,4157,16.1,27380,4915,22465,3.6,19.8,34270,17995,16275,13,24.8,-6890,-5,39.6,0,2922,2922,12963
2001,60,e) 4,21318,22621,142544,143551,848,3.6,3368,14.2,25635,4671,20964,3.3,17.9,29663,12629,17034,8.8,20.7,-4028,-2.8,35.8,0,2265,2265,8975
2001,60,f) 5,18644,19511,119936,123365,680,3.3,2744,13.4,18281,3203,15078,2.6,14.8,26066,12878,13188,10.4,21.1,-7785,-6.3,29.6,0,1863,1863,9318
2001,60,g) 6 to 10,70101,76440,591548,591169,2789,3.5,9849,12.4,105571,22633,82938,3.8,17.9,108013,52730,55283,8.9,18.3,-2442,-0.4,35.8,0,5608,5608,26384
2001,60,h) 11 to 15,51936,59636,475772,473663,2067,3.4,5488,9,74885,18300,56585,3.9,15.8,74156,33449,40707,7.1,15.7,729,0.1,31.4,0,3222,3222,15335
2001,60,i) 16 to 20,37813,49641,487129,481125,2384,4.7,4238,8.4,80767,31935,48832,6.6,16.8,70553,27983,42570,5.8,14.7,10214,2.1,29.4,0,1984,1984,9293
2001,60,j) 21 to 25,24451,36008,402535,407130,1930,5.3,3389,9.2,56473,16955,39518,4.2,13.9,67294,29533,37761,7.3,16.5,-10821,-2.6,27.8,0,1394,1394,6181
2001,60,l) Left Censored,63801,245771,5094094,4989574,24470,10,22652,9.3,994744,400444,594300,8,19.9,804020,315131,488889,6.3,16.1,190724,3.8,32.2,0,2775,2777,14599
2001,70,a) 0,187555,188983,1126889,563445,187440,198.4,0,0,1118016,1118016,0,198.4,198.4,0,0,0,0,0,1118016,198.4,0,0,,,
2001,70,b) 1,147502,148966,1200555,1163934,407,0.2,39971,23.7,376878,14127,362751,1.2,32.4,303933,174577,129356,15,26.1,72945,6.3,52.2,0,27777,27825,128259
2001,70,c) 2,129179,130284,1206074,1221833,3883,2.8,25809,18.3,297639,28406,269233,2.3,24.4,334450,173011,161439,14.2,27.4,-36811,-3,48.8,0,18366,18369,127953
2001,70,d) 3,119062,120478,1136274,1165699,3735,2.9,21012,16.3,222131,26001,196130,2.2,19.1,287678,144908,142770,12.4,24.7,-65547,-5.6,38.2,0,14898,14898,108473
2001,70,e) 4,105936,109521,1116066,1164182,3552,3.1,16561,14.3,192059,24539,167520,2.1,16.5,298852,128864,169988,11.1,25.7,-106793,-9.2,33,0,11474,11481,81549
2001,70,f) 5,92466,95798,1119988,1138489,3066,3,13565,13.5,199675,31312,168363,2.8,17.5,245697,99940,145757,8.8,21.6,-46022,-4.1,35,0,9327,9328,62152
2001,70,g) 6 to 10,346242,368966,4464110,4544962,10611,2.8,41287,10.8,666931,148788,518143,3.3,14.7,849041,323077,525964,7.1,18.7,-182110,-4,29.4,0,26561,26562,197079
2001,70,h) 11 to 15,255905,290868,5025798,5090496,8761,2.9,26142,8.8,587846,133288,454558,2.6,11.5,739496,241815,497681,4.8,14.5,-151650,-3,23,0,15221,15221,106023
2001,70,i) 16 to 20,220011,262260,4326062,4339951,7845,2.9,18503,6.9,541057,125373,415684,2.9,12.5,592773,187852,404921,4.3,13.7,-51716,-1.2,25,0,9591,9618,59757
2001,70,j) 21 to 25,120431,173541,3472272,3474425,7172,4.1,11929,6.8,446094,122905,323189,3.5,12.8,455681,152734,302947,4.4,13.1,-9587,-0.3,25.6,0,5329,5367,30667
2001,70,l) Left Censored,275042,468620,17519844,17484622,23709,5,31758,6.7,2167121,555313,1611808,3.2,12.4,2143258,594128,1549130,3.4,12.3,23863,0.1,24.6,0,10546,10575,90371
2002,07,a) 0,11686,11694,59528,29764,11694,200,0,0,59528,59528,0,200,200,0,0,0,0,0,59528,200,0,0,,,
2002,07,b) 1,8431,8507,55625,56954,15,0.2,2791,28.2,15876,225,15651,0.4,27.9,18533,9079,9454,15.9,32.5,-2657,-4.6,55.8,0,1411,1411,4647
2002,07,c) 2,7525,7580,55375,57489,410,4.9,1942,23.3,12632,3056,9576,5.3,22,16859,8114,8745,14.1,29.3,-4227,-7.3,44,0,811,811,3600
2002,07,d) 3,6616,6717,47463,48307,390,5.4,1357,18.8,11384,3949,7435,8.2,23.6,13071,6246,6825,12.9,27.1,-1687,-3.5,47.2,0,619,619,2714
2002,07,e) 4,5830,6059,52978,52525,370,5.8,1074,16.8,14237,5276,8961,10,27.1,13331,5157,8174,9.8,25.4,906,1.7,50.8,0,464,464,1807
2002,07,f) 5,5245,5248,36849,52701,274,4.9,978,17.5,7079,1549,5530,2.9,13.4,38783,3688,35095,7,73.6,-31704,-60.2,26.8,0,422,422,1583
2002,07,g) 6 to 10,19933,20443,190291,193038,999,4.7,3057,14.2,36895,7049,29846,3.7,19.1,42389,15351,27038,8,22,-5494,-2.9,38.2,0,1271,1271,5671
2002,07,h) 11 to 15,16278,16339,163748,169311,742,4.4,2139,12.6,30452,7351,23101,4.3,18,41578,19462,22116,11.5,24.6,-11126,-6.6,36,0,801,801,5654
2002,07,i) 16 to 20,9376,9510,105076,105807,314,3.2,930,9.5,15393,3944,11449,3.7,14.5,16855,4999,11856,4.7,15.9,-1462,-1.4,29,0,399,399,2490
2002,07,j) 21 to 25,6198,6364,70681,71916,201,3.1,587,9,8645,1305,7340,1.8,12,11115,3435,7680,4.8,15.5,-2470,-3.5,24,0,292,292,2033
2002,07,l) Left Censored,6692,8229,160493,161402,429,5.1,695,8.3,26631,7874,18757,4.9,16.5,28448,11919,16529,7.4,17.6,-1817,-1.1,33,0,300,303,1894
2002,10,a) 0,1510,1542,16684,8342,1542,200,0,0,16684,16684,0,200,200,0,0,0,0,0,16684,200,0,0,,,
2002,10,b) 1,1173,1220,10722,11069,10,0.7,329,23.8,2763,100,2663,0.9,25,3456,1867,1589,16.9,31.2,-693,-6.2,50,0,225,225,1271
2002,10,c) 2,875,908,7827,8273,30,3.1,178,18.1,1734,179,1555,2.2,21,2626,1534,1092,18.5,31.7,-892,-10.7,42,0,126,126,1364
2002,10,d) 3,724,759,8439,8479,22,2.7,109,13.6,1891,619,1272,7.3,22.3,1971,687,1284,8.1,23.2,-80,-0.9,44.6,0,67,67,568
2002,10,e) 4,732,779,9175,9805,44,5.4,108,13.3,1624,242,1382,2.5,16.6,2884,1753,1131,17.9,29.4,-1260,-12.8,33.2,0,75,75,1592
2002,10,f) 5,710,733,6852,7726,32,4.2,98,12.8,992,168,824,2.2,12.8,2739,867,1872,11.2,35.5,-1747,-22.7,25.6,0,67,67,706
2002,10,g) 6 to 10,2634,2907,30564,32119,108,3.6,326,10.8,4404,1233,3171,3.8,13.7,7514,2521,4993,7.8,23.4,-3110,-9.7,27.4,0,199,199,1598
2002,10,h) 11 to 15,2260,2470,33289,33405,153,6.1,256,10.2,6552,2619,3933,7.8,19.6,6784,1745,5039,5.2,20.3,-232,-0.7,39.2,0,138,138,1048
2002,10,i) 16 to 20,2159,2338,31245,32699,99,4.1,219,9.1,4211,792,3419,2.4,12.9,7119,2715,4404,8.3,21.8,-2908,-8.9,25.8,0,108,108,1064
2002,10,j) 21 to 25,1617,2194,40790,41621,98,4.3,216,9.6,5590,1492,4098,3.6,13.4,7251,2389,4862,5.7,17.4,-1661,-4,26.8,0,67,67,384
2002,10,l) Left Censored,2855,6524,283136,293705,394,5.9,676,10.1,39641,10529,29112,3.6,13.5,60779,23124,37655,7.9,20.7,-21138,-7.2,27,0,120,120,943
2002,15,a) 0,56001,56047,256000,128000,56047,200,0,0,256000,256000,0,200,200,0,0,0,0,0,256000,200,0,0,,,
2002,15,b) 1,43395,43439,239103,254779,14,0,15477,30.2,66346,1737,64609,0.7,26,97698,55092,42606,21.6,38.3,-31352,-12.3,52,0,9899,9900,39907
2002,15,c) 2,38830,38912,245336,261430,2059,4.8,9405,22.1,57240,8751,48489,3.3,21.9,89427,41104,48323,15.7,34.2,-32187,-12.3,43.8,0,5989,5993,29600
2002,15,d) 3,35498,35590,234992,248765,2058,5.4,7192,18.8,51820,11380,40440,4.6,20.8,79365,30879,48486,12.4,31.9,-27545,-11.1,41.6,0,4470,4471,22119
2002,15,e) 4,32416,32690,243465,254103,1765,5.1,5871,16.9,50623,9197,41426,3.6,19.9,71898,26951,44947,10.6,28.3,-21275,-8.4,39.8,0,3604,3604,19483
2002,15,f) 5,29909,29946,235946,244691,1592,5,4877,15.4,49062,6623,42439,2.7,20.1,66551,24299,42252,9.9,27.2,-17489,-7.1,40.2,0,2934,2934,17221
2002,15,g) 6 to 10,113130,113339,985903,1030373,5519,4.7,15510,13.1,172470,25529,146941,2.5,16.7,247469,75562,171907,7.3,24,-74999,-7.3,33.4,0,8861,8861,48773
2002,15,h) 11 to 15,81186,81477,850922,876962,3464,4.1,9366,11.1,133848,16423,117425,1.9,15.3,185928,47517,138411,5.4,21.2,-52080,-5.9,30.6,0,4957,4959,29881
2002,15,i) 16 to 20,52407,52861,697221,723674,1842,3.4,5245,9.6,95971,9671,86300,1.3,13.3,148876,33096,115780,4.6,20.6,-52905,-7.3,26.6,0,2807,2809,18385
2002,15,j) 21 to 25,38955,39839,600030,625678,1367,3.3,4192,10.2,78538,10862,67676,1.7,12.6,129833,28542,101291,4.6,20.8,-51295,-8.2,25.2,0,2176,2177,16310
2002,15,l) Left Censored,49937,55414,1624167,1668247,1474,2.6,4822,8.4,230263,36137,194126,2.2,13.8,317265,67604,249661,4.1,19,-87002,-5.2,27.6,0,2456,2460,19074
2002,20,a) 0,19172,19291,260036,130018,19291,200,0,0,260036,260036,0,200,200,0,0,0,0,0,260036,200,0,0,,,
2002,20,b) 1,15763,15882,165333,175696,65,0.4,4556,25.1,38268,2871,35397,1.6,21.8,58993,28497,30496,16.2,33.6,-20725,-11.8,43.6,0,3301,3301,21984
2002,20,c) 2,14500,14769,167064,187090,573,3.6,3263,20.2,29124,6275,22849,3.4,15.6,69175,35168,34007,18.8,37,-40051,-21.4,31.2,0,2482,2488,29186
2002,20,d) 3,12953,13365,180283,192861,547,3.8,2400,16.8,29322,6562,22760,3.4,15.2,54477,23241,31236,12.1,28.2,-25155,-13,30.4,0,1831,1831,18501
2002,20,e) 4,12466,12914,171651,181345,619,4.5,2045,15,30952,10516,20436,5.8,17.1,50339,18992,31347,10.5,27.8,-19387,-10.7,34.2,0,1587,1587,15536
2002,20,f) 5,11381,11548,175482,190842,415,3.4,1739,14.2,23511,7286,16225,3.8,12.3,54231,16791,37440,8.8,28.4,-30720,-16.1,24.6,0,1284,1290,11950
2002,20,g) 6 to 10,45731,46766,746557,792542,1624,3.3,5814,11.9,88275,21329,66946,2.7,11.1,180244,60211,120033,7.6,22.7,-91969,-11.6,22.2,0,4223,4224,44967
2002,20,h) 11 to 15,37670,39350,944139,1004028,1129,2.8,3858,9.5,99834,23897,75937,2.4,9.9,219611,74549,145062,7.4,21.9,-119777,-12,19.8,0,2574,2579,33554
2002,20,i) 16 to 20,29962,32960,1144510,1220646,905,2.7,2840,8.4,105844,32647,73197,2.7,8.7,263267,76582,186685,6.3,21.6,-157423,-12.9,17.4,0,1650,1662,21391
2002,20,j) 21 to 25,24916,29573,1229772,1311241,769,2.5,2514,8.3,94027,23271,70756,1.8,7.2,255502,74209,181293,5.7,19.5,-161475,-12.3,14.4,0,1301,1305,21704
2002,20,l) Left Censored,58765,106307,11088903,11669445,3252,3,9233,8.4,825732,222405,603327,1.9,7.1,1953373,529348,1424025,4.5,16.7,-1127641,-9.6,14.2,0,2498,2559,65838
2002,40,a) 0,21985,22485,137343,68672,22485,200,0,0,137343,137343,0,200,200,0,0,0,0,0,137343,200,0,0,,,
2002,40,b) 1,16498,16817,111462,117551,140,0.7,6371,32,32429,3210,29219,2.7,27.6,44606,27035,17571,23,37.9,-12177,-10.3,55.2,0,4670,4675,21489
2002,40,c) 2,14707,15131,125863,137034,721,4.3,3874,23.2,24929,5258,19671,3.8,18.2,47271,19488,27783,14.2,34.5,-22342,-16.3,36.4,0,2873,2883,15271
2002,40,d) 3,12852,13840,139738,147434,970,6.5,3049,20.5,28320,8287,20033,5.6,19.2,43712,18015,25697,12.2,29.6,-15392,-10.4,38.4,0,2271,2280,13796
2002,40,e) 4,11278,12884,131892,137791,780,5.7,2312,16.9,28526,8652,19874,6.3,20.7,40323,14725,25598,10.7,29.3,-11797,-8.6,41.4,0,1637,1637,9289
2002,40,f) 5,9812,10167,101840,107408,524,4.8,1906,17.6,19162,4026,15136,3.7,17.8,29128,12775,16353,11.9,27.1,-9966,-9.3,35.6,0,1309,1309,8231
2002,40,g) 6 to 10,36138,38639,410022,433818,2029,5,6098,15,65287,21142,44145,4.9,15,112879,41377,71502,9.5,26,-47592,-11,30,0,3910,3912,22911
2002,40,h) 11 to 15,23353,30264,498940,528976,1440,4.6,3763,12,63665,19518,44147,3.7,12,123736,42616,81120,8.1,23.4,-60071,-11.4,24,0,1870,1871,17830
2002,40,i) 16 to 20,14636,31253,778234,800828,4352,13.3,7331,22.4,183475,106502,76973,13.3,22.9,229928,113138,116790,14.1,28.7,-46453,-5.8,45.8,0,1101,1112,9662
2002,40,j) 21 to 25,10460,21243,569933,582603,1934,9,2275,10.6,82853,27322,55531,4.7,14.2,98193,36683,61510,6.3,16.9,-15340,-2.7,28.4,0,620,622,5086
2002,40,l) Left Censored,19061,80438,3684864,3741322,9121,11.4,7697,9.7,512265,279618,232647,7.5,13.7,617566,149160,468406,4,16.5,-105301,-2.8,27.4,0,826,833,9961
2002,50,a) 0,28366,30024,196204,98102,30024,200,0,0,196204,196204,0,200,200,0,0,0,0,0,196204,200,0,0,,,
2002,50,b) 1,20202,20806,125715,129112,337,1.4,5657,24.1,34905,6087,28818,4.7,27,41698,22981,18717,17.8,32.3,-6793,-5.3,54,0,4029,4034,17476
2002,50,c) 2,18384,18997,134303,142720,922,4.5,3796,18.6,26464,6259,20205,4.4,18.5,43297,19886,23411,13.9,30.3,-16833,-11.8,37,0,2852,2852,16240
2002,50,d) 3,16900,17759,126140,132950,862,4.6,2903,15.5,25929,7406,18523,5.6,19.5,39548,15816,23732,11.9,29.7,-13619,-10.2,39,0,2129,2129,11830
2002,50,e) 4,15998,17137,133479,136104,1049,5.9,2446,13.7,28860,9724,19136,7.1,21.2,34110,11798,22312,8.7,25.1,-5250,-3.9,42.4,0,1787,1787,9033
2002,50,f) 5,15131,15458,120336,123115,564,3.5,2314,14.2,21974,5730,16244,4.7,17.8,27531,10857,16674,8.8,22.4,-5557,-4.6,35.6,0,1583,1583,7260
2002,50,g) 6 to 10,63206,65145,554322,579050,2254,3.3,8155,12,78606,15953,62653,2.8,13.6,124211,46591,77620,8,21.5,-45605,-7.9,27.2,0,5424,5426,31058
2002,50,h) 11 to 15,47977,53130,624672,642980,1783,3.2,5535,10.1,88811,21316,67495,3.3,13.8,125426,46047,79379,7.2,19.5,-36615,-5.7,27.6,0,3033,3052,18789
2002,50,i) 16 to 20,36750,45158,635960,659234,1986,4.3,4866,10.4,80582,22976,57606,3.5,12.2,127129,48994,78135,7.4,19.3,-46547,-7.1,24.4,0,2003,2037,16044
2002,50,j) 21 to 25,28541,40204,671729,691577,1769,4.3,4070,9.8,89939,27905,62034,4,13,126105,46219,79886,6.7,18.2,-36166,-5.2,26,0,1420,1429,11477
2002,50,l) Left Censored,58428,142160,3592554,3683619,8404,5.8,15960,10.9,519260,163018,356242,4.4,14.1,693907,261787,432120,7.1,18.8,-174647,-4.7,28.2,0,2511,2561,28493
2002,52,a) 0,109661,111245,845535,422768,111245,200,0,0,845535,845535,0,200,200,0,0,0,0,0,845535,200,0,0,,,
2002,52,b) 1,80062,82226,665108,707808,776,0.8,24270,25.8,143250,13192,130058,1.9,20.2,228649,119647,109002,16.9,32.3,-85399,-12.1,40.4,0,18843,18868,97159
2002,52,c) 2,68061,71067,624847,660886,3260,4.2,15157,19.7,113200,24926,88274,3.8,17.1,185277,93779,91498,14.2,28,-72077,-10.9,34.2,0,12118,12164,78778
2002,52,d) 3,58577,62772,617533,643844,3080,4.6,11335,16.9,105105,25276,79829,3.9,16.3,157727,72643,85084,11.3,24.5,-52622,-8.2,32.6,0,9043,9099,58314
2002,52,e) 4,53078,58924,586676,605651,2991,4.8,8973,14.5,96674,24970,71704,4.1,16,134624,54419,80205,9,22.2,-37950,-6.2,32,0,7127,7134,45058
2002,52,f) 5,47178,50771,495304,517324,2139,4,7981,14.9,71850,15693,56157,3,13.9,113891,50966,62925,9.9,22,-42041,-8.1,27.8,0,5930,5937,37976
2002,52,g) 6 to 10,171874,189833,2050683,2111936,8329,4.2,25391,12.8,295173,77815,217358,3.7,14,417678,171178,246500,8.1,19.8,-122505,-5.8,28,0,17312,17348,110793
2002,52,h) 11 to 15,117096,146571,1889769,1923196,7224,4.8,16507,10.9,276549,86882,189667,4.5,14.4,343403,141030,202373,7.3,17.9,-66854,-3.5,28.8,0,9437,9471,65382
2002,52,i) 16 to 20,81257,113620,1740636,1775553,5561,4.8,12427,10.6,242217,86912,155305,4.9,13.6,310247,117816,192431,6.6,17.5,-68030,-3.9,27.2,0,5585,5641,39575
2002,52,j) 21 to 25,62515,113891,2137870,2163270,6388,5.5,11947,10.2,310451,118828,191623,5.5,14.4,361250,127393,233857,5.9,16.7,-50799,-2.3,28.8,0,3815,3891,28071
2002,52,l) Left Censored,99579,441143,11777101,11856982,30809,6.9,37667,8.5,1561771,624514,937257,5.3,13.2,1712478,519615,1192863,4.4,14.4,-150707,-1.2,26.4,0,5625,5669,44619
2002,60,a) 0,44185,45228,214124,107062,45228,200,0,0,214124,214124,0,200,200,0,0,0,0,0,214124,200,0,0,,,
2002,60,b) 1,33540,34484,181016,189521,470,1.2,9160,23.6,44479,4799,39680,2.5,23.5,61489,31241,30248,16.5,32.4,-17010,-8.9,47,0,6155,6160,23481
2002,60,c) 2,28272,29447,175044,175618,1497,4.8,5278,16.8,44371,7809,36562,4.4,25.3,46833,22815,24018,13,26.7,-2462,-1.4,50.6,0,3707,3709,18300
2002,60,d) 3,25841,27930,174300,174537,1667,5.7,3989,13.7,36735,10021,26714,5.7,21,37208,15038,22170,8.6,21.3,-473,-0.3,42,0,2811,2811,11695
2002,60,e) 4,22463,25800,173904,171711,1718,6.5,3100,11.7,40053,12837,27216,7.5,23.3,35666,12939,22727,7.5,20.8,4387,2.5,41.6,0,2139,2139,9885
2002,60,f) 5,19540,20887,144408,140084,1021,4.7,2607,12,36126,5047,31079,3.6,25.8,27478,10728,16750,7.7,19.6,8648,6.2,39.2,0,1645,1645,6955
2002,60,g) 6 to 10,72421,77303,560905,574982,4223,5.3,8372,10.5,95910,30093,65817,5.2,16.7,122915,54402,68513,9.5,21.4,-27005,-4.7,33.4,0,5211,5215,32043
2002,60,h) 11 to 15,52376,62147,519745,513723,3713,5.9,5630,8.9,93390,32393,60997,6.3,18.2,84126,29304,54822,5.7,16.4,9264,1.8,32.8,0,3003,3006,12825
2002,60,i) 16 to 20,39252,51662,500678,499578,2955,5.6,4414,8.4,97336,32202,65134,6.4,19.5,96235,33267,62968,6.7,19.3,1101,0.2,38.6,0,1941,1944,9030
2002,60,j) 21 to 25,29963,44559,505958,501035,3027,6.8,3513,7.8,99575,38704,60871,7.7,19.9,89728,29149,60579,5.8,17.9,9847,2,35.8,0,1393,1398,5344
2002,60,l) Left Censored,61795,242776,5234009,5182599,22408,9.1,27902,11.4,923933,367790,556143,7.1,17.8,856645,325015,531630,6.3,16.5,67288,1.3,33,0,2322,2345,12096
2002,70,a) 0,199450,201660,1293632,646816,201655,200,0,0,1280303,1280303,0,197.9,197.9,0,0,0,0,0,1280303,197.9,0,0,,,
2002,70,b) 1,149366,152374,1204063,1195743,1165,0.7,43495,25.1,364031,24584,339447,2.1,30.4,342049,183576,158473,15.4,28.6,21982,1.8,57.2,0,29904,29941,139858
2002,70,c) 2,129526,133728,1219332,1255884,6303,4.4,26374,18.3,274968,55452,219516,4.4,21.9,341290,154134,187156,12.3,27.2,-66322,-5.3,43.8,0,18669,18723,122926
2002,70,d) 3,117532,122936,1262334,1305475,6421,5,19972,15.4,258920,61397,197523,4.7,19.8,341056,141794,199262,10.9,26.1,-82136,-6.3,39.6,0,13877,13890,111535
2002,70,e) 4,110886,123160,1390276,1414553,7447,5.8,16797,13.1,275758,80945,194813,5.7,19.5,327232,109243,217989,7.7,23.1,-51474,-3.6,39,0,11519,11533,81268
2002,70,f) 5,96228,99644,1003303,1052233,4458,4.3,14194,13.6,167888,33940,133948,3.2,16,261781,109879,151902,10.4,24.9,-93893,-8.9,32,0,9407,9452,76812
2002,70,g) 6 to 10,354400,374829,4452498,4636552,16480,4.2,43775,11.3,725075,159494,565581,3.4,15.6,1077344,434948,642396,9.4,23.2,-352269,-7.6,31.2,0,26582,26634,205295
2002,70,h) 11 to 15,255404,286764,4699037,4807689,12773,4.4,26368,9,640637,139959,500678,2.9,13.3,839865,311502,528363,6.5,17.5,-199228,-4.2,26.6,0,14249,14268,115204
2002,70,i) 16 to 20,223900,266494,4255844,4321268,11501,4.2,21595,8,581408,158247,423161,3.7,13.5,743323,271457,471866,6.3,17.2,-161915,-3.7,27,0,9487,9580,73438
2002,70,j) 21 to 25,150155,211351,4258477,4320208,10622,4.9,18139,8.4,584090,169919,414171,3.9,13.5,708555,268193,440362,6.2,16.4,-124465,-2.9,27,0,6264,6306,45556
2002,70,l) Left Censored,267023,467494,17372490,17534952,32046,6.8,38791,8.2,2425146,770080,1655066,4.4,13.8,2688668,915720,1772948,5.2,15.3,-263522,-1.5,27.6,0,9245,9341,94856
2003,07,a) 0,10855,10858,50086,25043,10858,200,0,0,50086,,,,200,0,0,0,0,0,50086,200,0,1,,,
2003,07,b) 1,8538,8547,50845,55186,2,0,2844,28.1,11827,,,,21.4,19691,11599,8092,21,35.7,-7864,-14.3,42.8,1,1573,1573,6445
2003,07,c) 2,7275,7346,48523,51750,491,6.2,1444,18.3,11764,1350,10414,2.6,22.7,17422,9565,7857,18.5,33.7,-5658,-11,45.4,0,863,863,4668
2003,07,d) 3,6729,6783,54547,54561,528,7.4,1163,16.3,12417,2041,10376,3.7,22.8,12016,6204,5812,11.4,22,401,0.8,44,0,666,666,3608
2003,07,e) 4,5985,6074,43415,44674,413,6.5,906,14.2,9393,1788,7605,4,21,11183,3729,7454,8.3,25,-1790,-4,42,0,534,534,2276
2003,07,f) 5,5287,5500,51142,51794,311,5.4,729,12.7,10297,1965,8332,3.8,19.9,10793,4807,5986,9.3,20.8,-496,-0.9,39.8,0,428,428,2355
2003,07,g) 6 to 10,20215,20789,190241,192279,1298,6.1,2298,10.7,36101,8227,27874,4.3,18.8,38661,16415,22246,8.5,20.1,-2560,-1.3,37.6,0,1272,1272,9278
2003,07,h) 11 to 15,16209,16295,161324,165100,944,5.7,1642,9.8,27838,6056,21782,3.7,16.9,34507,11587,22920,7,20.9,-6669,-4,33.8,0,798,798,5173
2003,07,i) 16 to 20,9936,10085,107903,108525,404,3.9,745,7.2,15248,2420,12828,2.2,14.1,15980,3803,12177,3.5,14.7,-732,-0.6,28.2,0,418,418,2370
2003,07,j) 21 to 25,6261,6452,75277,75850,208,3.2,426,6.5,9172,1039,8133,1.4,12.1,10127,2365,7762,3.1,13.4,-955,-1.3,24.2,0,244,244,1654
2003,07,k) 26+,1033,1063,12413,12659,42,3.9,87,8,1529,299,1230,2.4,12.1,2008,445,1563,3.5,15.9,-479,-3.8,24.2,0,50,50,361
2003,07,l) Left Censored,6240,7791,152251,154677,323,4.1,491,6.2,20024,5959,14065,3.9,12.9,24794,4723,20071,3.1,16,-4770,-3.1,25.8,0,274,274,1419
2003,10,a) 0,1130,1137,10595,5298,1137,200,0,0,10595,10595,0,200,200,0,0,0,0,0,10595,200,0,0,,,
2003,10,b) 1,1158,1170,13490,14213,4,0.3,311,23.2,3801,54,3747,0.4,26.7,5097,2897,2200,20.4,35.9,-1296,-9.2,53.4,0,241,247,2667
2003,10,c) 2,975,990,9201,9539,40,3.7,190,17.6,1918,273,1645,2.9,20.1,2494,1261,1233,13.2,26.1,-576,-6,40.2,0,149,149,903
2003,10,d) 3,758,774,6529,6942,31,3.7,124,15,1081,56,1025,0.8,15.6,1753,858,895,12.4,25.3,-672,-9.7,31.2,0,104,104,745
2003,10,e) 4,642,655,7874,7962,29,4.2,86,12.4,1191,311,880,3.9,15,1277,501,776,6.3,16,-86,-1,30,0,66,66,388
2003,10,f) 5,665,692,8052,8365,39,5.4,84,11.6,1139,159,980,1.9,13.6,1667,841,826,10.1,19.9,-528,-6.3,27.2,0,64,64,685
2003,10,g) 6 to 10,2653,2909,32294,32442,113,3.7,290,9.6,5975,1656,4319,5.1,18.4,6044,2702,3342,8.3,18.6,-69,-0.2,36.8,0,206,206,1993
2003,10,h) 11 to 15,2171,2316,29784,30873,98,4.1,235,9.8,4193,798,3395,2.6,13.6,6171,2489,3682,8.1,20,-1978,-6.4,27.2,0,156,160,1653
2003,10,i) 16 to 20,1943,2129,28314,29310,80,3.7,135,6.2,3078,397,2681,1.4,10.5,4984,678,4306,2.3,17,-1906,-6.5,21,0,101,101,498
2003,10,j) 21 to 25,1773,2030,33670,33613,118,5.8,126,6.2,5173,1615,3558,4.8,15.4,4770,1550,3220,4.6,14.2,403,1.2,28.4,0,86,86,1165
2003,10,k) 26+,247,636,14411,14430,8,1.2,24,3.7,1431,88,1343,0.6,9.9,1469,519,950,3.6,10.2,-38,-0.3,19.8,0,11,11,58
2003,10,l) Left Censored,2660,6171,254922,265571,357,5.8,385,6.2,32995,9898,23097,3.7,12.4,54090,14143,39947,5.3,20.4,-21095,-8,24.8,0,114,114,1057
2003,15,a) 0,43162,43191,194771,97386,43191,200,0,0,194771,194771,0,200,200,0,0,0,0,0,194771,200,0,0,,,
2003,15,b) 1,39760,39812,229986,243641,7,0,14641,30.5,67650,51,67599,0,27.8,89657,53124,36533,21.8,36.8,-22007,-9,55.6,0,10632,10633,43140
2003,15,c) 2,36991,37032,222581,229991,2327,5.8,7788,19.4,57129,8119,49010,3.5,24.8,68795,33009,35786,14.4,29.9,-11666,-5.1,49.6,0,5637,5637,26525
2003,15,d) 3,33941,34016,228415,236569,2097,5.8,6355,17.4,54078,7566,46512,3.2,22.9,68335,27270,41065,11.5,28.9,-14257,-6,45.8,0,4459,4459,21076
2003,15,e) 4,31571,31684,226804,235560,1842,5.5,5138,15.3,50354,7599,42755,3.2,21.4,65468,24238,41230,10.3,27.8,-15114,-6.4,42.8,0,3572,3572,17635
2003,15,f) 5,29250,29533,230991,237323,1582,5.1,4250,13.7,47461,6073,41388,2.6,20,58134,19767,38367,8.3,24.5,-10673,-4.5,40,0,2885,2885,15362
2003,15,g) 6 to 10,115634,115772,992137,1021709,5791,4.8,13942,11.6,181546,23429,158117,2.3,17.8,233228,70055,163173,6.9,22.8,-51682,-5,35.6,0,9309,9309,48367
2003,15,h) 11 to 15,78284,78690,824541,840309,3516,4.3,7667,9.4,137419,18532,118887,2.2,16.4,164621,40247,124374,4.8,19.6,-27202,-3.2,32.8,0,4794,4794,29577
2003,15,i) 16 to 20,57067,57496,724437,738721,2162,3.7,4993,8.4,108970,9501,99469,1.3,14.8,134503,28342,106161,3.8,18.2,-25533,-3.4,29.6,0,3184,3184,20544
2003,15,j) 21 to 25,36919,37468,544048,553977,1351,3.5,3068,8,76144,9284,66860,1.7,13.7,93860,17703,76157,3.2,16.9,-17716,-3.2,27.4,0,1919,1919,11326
2003,15,k) 26+,6546,6859,117880,119902,230,3.2,635,8.9,16778,1617,15161,1.3,14,20485,4337,16148,3.6,17.1,-3707,-3.1,28,0,369,369,2222
2003,15,l) Left Censored,47236,52703,1543100,1586937,1350,2.5,3627,6.7,207480,25202,182278,1.6,13.1,292618,46362,246256,2.9,18.4,-85138,-5.3,26.2,0,2393,2394,19154
2003,20,a) 0,17212,17291,219722,109861,17291,200,0,0,219722,219722,0,200,200,0,0,0,0,0,219722,200,0,0,,,
2003,20,b) 1,14641,14759,200991,227797,32,0.2,4202,24.7,46732,961,45771,0.4,20.5,97385,65856,31529,28.9,42.8,-50653,-22.3,41,0,3476,3478,58104
2003,20,c) 2,13451,13558,150943,157377,561,3.8,2595,17.7,29808,4658,25150,3,18.9,40346,19903,20443,12.6,25.6,-10538,-6.7,37.8,0,2141,2142,16999
2003,20,d) 3,12681,12935,153522,159863,524,3.8,2139,15.5,26216,3153,23063,2,16.4,37658,18676,18982,11.7,23.6,-11442,-7.2,32.8,0,1783,1783,15818
2003,20,e) 4,11586,11904,171226,175335,474,3.8,1747,13.9,28866,5667,23199,3.2,16.5,36425,17252,19173,9.8,20.8,-7559,-4.3,33,0,1394,1396,14011
2003,20,f) 5,11271,11732,160247,165053,446,3.6,1465,11.9,26757,5672,21085,3.4,16.2,35533,13648,21885,8.3,21.5,-8776,-5.3,32.4,0,1196,1196,11011
2003,20,g) 6 to 10,45555,46467,749778,764615,1596,3.3,4964,10.3,106779,19809,86970,2.6,14,133614,49870,83744,6.5,17.5,-26835,-3.5,28,0,4064,4071,39297
2003,20,h) 11 to 15,36079,37557,866892,879418,1042,2.7,3016,7.8,103805,15188,88617,1.7,11.8,127064,38448,88616,4.4,14.4,-23259,-2.6,23.6,0,2335,2336,25678
2003,20,i) 16 to 20,29931,32556,1038127,1058520,863,2.6,2259,6.8,110244,27450,82794,2.6,10.4,149370,40295,109075,3.8,14.1,-39126,-3.7,20.8,0,1675,1682,23080
2003,20,j) 21 to 25,23947,27619,1044888,1065043,633,2.2,1716,6.1,106793,19898,86895,1.9,10,145372,33802,111570,3.2,13.6,-38579,-3.6,20,0,1217,1243,16848
2003,20,k) 26+,4729,6347,366556,369438,177,2.7,359,5.6,34409,7284,27125,2,9.3,39215,8491,30724,2.3,10.6,-4806,-1.3,18.6,0,217,218,3225
2003,20,l) Left Censored,56081,101840,10544157,10754142,2475,2.4,4855,4.7,764317,140748,623569,1.3,7.1,1176887,244632,932255,2.3,10.9,-412570,-3.8,14.2,0,2307,2372,43851
2003,40,a) 0,21225,21313,123103,61552,21313,200,0,0,123103,123103,0,200,200,0,0,0,0,0,123103,200,0,0,,,
2003,40,b) 1,15876,16488,125212,131098,158,0.8,5593,28.7,35296,4997,30299,3.8,26.9,45120,26596,18524,20.3,34.4,-9824,-7.5,53.8,0,4545,4548,22924
2003,40,c) 2,13739,14106,108771,110860,758,4.9,3189,20.7,23486,3482,20004,3.1,21.2,26892,14030,12862,12.7,24.3,-3406,-3.1,42.4,0,2627,2627,12219
2003,40,d) 3,12566,13012,109131,116947,676,4.8,2532,18,22014,3479,18535,3,18.8,36840,16613,20227,14.2,31.5,-14826,-12.7,37.6,0,2038,2052,13202
2003,40,e) 4,11177,12167,131764,135661,607,4.7,2075,16,20947,3298,17649,2.4,15.4,28161,12056,16105,8.9,20.8,-7214,-5.4,30.8,0,1640,1653,10092
2003,40,f) 5,9908,11911,133223,135189,539,4.3,1655,13.2,22630,3619,19011,2.7,16.7,25954,9849,16105,7.3,19.2,-3324,-2.5,33.4,0,1331,1331,6413
2003,40,g) 6 to 10,36527,38235,398831,411059,1765,4.4,5103,12.7,68299,17157,51142,4.2,16.6,89629,29728,59901,7.2,21.8,-21330,-5.2,33.2,0,4071,4078,23927
2003,40,h) 11 to 15,22761,27109,393313,400288,1184,4.2,3148,11.2,61343,12195,49148,3,15.3,73787,31237,42550,7.8,18.4,-12444,-3.1,30.6,0,1904,1904,14095
2003,40,i) 16 to 20,15239,25468,635220,634603,1228,4.7,2530,9.7,101823,17983,83840,2.8,16,99882,33842,66040,5.3,15.7,1941,0.3,31.4,0,1245,1252,9328
2003,40,j) 21 to 25,9993,22864,518977,516844,1192,5.2,1040,4.6,46468,16675,29793,3.2,9,41654,13800,27854,2.7,8.1,4814,0.9,16.2,0,699,700,6680
2003,40,k) 26+,1985,8325,323608,332794,952,11.5,902,10.9,47179,11292,35887,3.4,14.2,62882,13292,49590,4,18.9,-15703,-4.7,28.4,0,109,109,751
2003,40,l) Left Censored,18127,81247,3598396,3620214,10322,12.9,7658,9.6,634935,341750,293185,9.4,17.5,484227,184945,299282,5.1,13.4,150708,4.1,26.8,0,860,861,8812
2003,50,a) 0,26379,26523,127010,63505,26523,200,0,0,127010,127010,0,200,200,0,0,0,0,0,127010,200,0,0,,,
2003,50,b) 1,22185,23955,177790,187479,158,0.6,5727,21.2,35849,1803,34046,1,19.1,53199,33841,19358,18.1,28.4,-17350,-9.3,38.2,0,4551,4551,29987
2003,50,c) 2,17506,18090,119656,120612,751,3.9,3083,15.9,25401,2679,22722,2.2,21.1,26528,13337,13191,11.1,22,-1127,-0.9,42.2,0,2494,2494,11071
2003,50,d) 3,16260,16907,124680,129747,691,3.9,2542,14.2,23728,4347,19381,3.4,18.3,26461,12778,13683,9.8,20.4,-2733,-2.1,36.6,0,2085,2085,10791
2003,50,e) 4,15244,16087,122861,124178,714,4.2,2149,12.7,21411,3813,17598,3.1,17.2,22295,10104,12191,8.1,18,-884,-0.8,34.4,0,1681,1681,8310
2003,50,f) 5,14481,15666,126908,128285,622,3.8,1875,11.5,21533,3909,17624,3,16.8,23194,9764,13430,7.6,18.1,-1661,-1.3,33.6,0,1469,1469,8058
2003,50,g) 6 to 10,62456,64247,561741,565161,2347,3.5,6660,10,92137,14884,77253,2.6,16.3,96438,37414,59024,6.6,17.1,-4301,-0.8,32.6,0,5176,5177,29157
2003,50,h) 11 to 15,46821,51249,600509,602274,1584,3,4129,7.8,87641,12454,75187,2.1,14.6,88881,26561,62320,4.4,14.8,-1240,-0.2,29.2,0,3047,3051,18533
2003,50,i) 16 to 20,36822,44429,615319,617356,1259,2.8,2967,6.5,77765,12980,64785,2.1,12.6,80546,25300,55246,4.1,13,-2781,-0.4,25.2,0,2044,2076,17382
2003,50,j) 21 to 25,27481,35189,574117,573767,840,2.3,2143,6,66879,11007,55872,1.9,11.7,65430,19602,45828,3.4,11.4,1449,0.3,22.8,0,1396,1464,12333
2003,50,k) 26+,5725,11165,226382,226717,287,2.6,405,3.6,21401,2752,18649,1.2,9.4,21949,6115,15834,2.7,9.7,-548,-0.3,18.8,0,199,210,1540
2003,50,l) Left Censored,55603,136185,3506505,3517500,5342,3.9,7371,5.4,426130,115351,310779,3.3,12.1,445831,111252,334579,3.2,12.7,-19701,-0.6,24.2,0,2184,2220,24317
2003,52,a) 0,107655,109538,838556,419278,109538,200,0,0,838556,838556,0,200,200,0,0,0,0,0,838556,200,0,0,,,
2003,52,b) 1,83471,85415,731563,788290,440,0.4,24645,25.1,151841,3652,148189,0.5,19.3,258607,148937,109670,18.9,32.8,-106766,-13.5,38.6,0,20636,20638,129557
2003,52,c) 2,67961,70265,611406,637580,2929,3.8,13886,18.2,111295,16375,94920,2.6,17.5,158885,86270,72615,13.5,24.9,-47590,-7.4,35,0,11765,11765,75053
2003,52,d) 3,59120,62232,589463,607143,2501,3.8,10615,15.9,98968,14048,84920,2.3,16.3,131529,64839,66690,10.7,21.7,-32561,-5.4,32.6,0,8877,8878,54387
2003,52,e) 4,51885,56382,587588,601438,2253,3.8,8058,13.5,92932,16271,76661,2.7,15.5,118072,50627,67445,8.4,19.6,-25140,-4.1,31,0,6706,6706,42197
2003,52,f) 5,47553,54061,563626,574274,2476,4.4,6869,12.2,91904,20023,71881,3.5,16,110410,45826,64584,8,19.2,-18506,-3.2,32,0,5686,5686,37929
2003,52,g) 6 to 10,174825,191128,2095491,2121198,7360,3.7,21629,10.9,327648,60462,267186,2.9,15.4,370340,147990,222350,7,17.5,-42692,-2.1,30.8,0,17486,17519,119954
2003,52,h) 11 to 15,114720,142651,1886552,1881816,5250,3.6,12096,8.3,285662,52275,233387,2.8,15.2,270229,90265,179964,4.8,14.4,15433,0.8,28.8,0,8882,8931,62331
2003,52,i) 16 to 20,83160,117162,1845400,1827834,4831,4.1,7968,6.7,264141,70449,193692,3.9,14.5,225509,75219,150290,4.1,12.3,38632,2.2,24.6,0,5713,5734,45615
2003,52,j) 21 to 25,58322,91486,1753335,1734075,3372,3.6,5146,5.6,227379,86064,141315,5,13.1,186333,44584,141749,2.6,10.7,41046,2.4,21.4,0,3499,3538,28538
2003,52,k) 26+,13037,36888,706779,698433,1548,4.2,1742,4.7,104297,29496,74801,4.2,14.9,87291,21144,66147,3,12.5,17006,2.4,25,0,643,664,6429
2003,52,l) Left Censored,93914,432429,11726649,11650140,22510,5.2,16395,3.8,1329395,481270,848125,4.1,11.4,1166556,249851,916705,2.1,10,162839,1.4,20,0,4988,5101,43364
2003,60,a) 0,45669,45863,188479,94240,45863,200,0,0,188479,188479,0,200,200,0,0,0,0,0,188479,200,0,0,,,
2003,60,b) 1,34438,35695,203203,207568,332,0.8,8804,21.8,53174,2611,50563,1.3,25.6,59620,36983,22637,17.8,28.7,-6446,-3.1,51.2,0,6607,6626,30611
2003,60,c) 2,29521,31399,186690,183276,2257,6.9,4668,14.2,44411,9208,35203,5,24.2,36369,16146,20223,8.8,19.8,8042,4.4,39.6,0,3667,3667,12930
2003,60,d) 3,25436,26934,183502,177215,1434,5.1,3472,12.3,50854,6780,44074,3.8,28.7,36551,13708,22843,7.7,20.6,14303,8.1,41.2,0,2716,2716,11350
2003,60,e) 4,23690,25965,175433,174442,1303,4.8,2846,10.6,34322,5110,29212,2.9,19.7,31111,12842,18269,7.4,17.8,3211,1.9,35.6,0,2160,2160,9485
2003,60,f) 5,20879,24569,184516,178836,1349,5.4,2229,8.9,44021,16654,27367,9.3,24.6,31929,12836,19093,7.2,17.9,12092,6.7,35.8,0,1682,1684,10088
2003,60,g) 6 to 10,75535,80353,587917,592944,3724,4.5,7386,8.9,109413,25312,84101,4.3,18.5,116525,38749,77776,6.5,19.7,-7112,-1.2,37,0,5396,5396,27704
2003,60,h) 11 to 15,51168,60733,524481,521325,3160,5.1,4380,7.1,85452,21769,63683,4.2,16.4,78010,26834,51176,5.1,15,7442,1.4,30,0,3065,3069,16047
2003,60,i) 16 to 20,41081,52311,470947,470214,2385,4.5,3299,6.2,74287,19595,54692,4.2,15.8,71923,26348,45575,5.6,15.3,2364,0.5,30.6,0,2124,2127,10187
2003,60,j) 21 to 25,29021,38231,390725,396679,1560,4,2163,5.6,61403,16861,44542,4.3,15.5,72121,19003,53118,4.8,18.2,-10718,-2.7,31,0,1410,1411,6548
2003,60,k) 26+,5939,13851,203895,203416,1063,7.8,574,4.2,28543,7648,20895,3.8,14,27534,4770,22764,2.3,13.5,1009,0.5,27,0,246,255,992
2003,60,l) Left Censored,59213,248986,5099844,5157839,29119,11.9,20035,8.2,810487,334554,475933,6.5,15.7,923976,322383,601593,6.3,17.9,-113489,-2.2,31.4,0,2259,2289,17817
2003,70,a) 0,211805,212671,1308759,654380,212671,200,0,0,1308759,,,,200,0,0,0,0,0,1308759,200,0,1,,,
2003,70,b) 1,155478,157880,1289222,1288644,436,0.2,39600,22,348825,,,,27.1,333912,197085,136827,15.3,25.9,14913,1.2,51.8,1,30060,30084,165624
2003,70,c) 2,130089,133301,1182051,1191906,6326,4.4,22553,15.8,269793,33708,236085,2.8,22.6,281878,140701,141177,11.8,23.6,-12085,-1,45.2,0,17697,17700,120410
2003,70,d) 3,115540,120142,1184298,1198930,5713,4.5,17222,13.6,249900,37931,211969,3.2,20.8,271477,106428,165049,8.9,22.6,-21577,-1.8,41.6,0,13337,13339,89879
2003,70,e) 4,106643,112340,1223366,1241057,5412,4.6,14200,12.1,239227,31744,207483,2.6,19.3,268934,122279,146655,9.9,21.7,-29707,-2.4,38.6,0,10864,10897,99699
2003,70,f) 5,101505,114311,1375293,1384444,5281,4.5,12540,10.6,254791,45049,209742,3.3,18.4,268012,93458,174554,6.8,19.4,-13221,-1,36.8,0,9397,9399,74472
2003,70,g) 6 to 10,365692,382870,4509147,4553927,16460,4.2,37594,9.5,762214,138520,623694,3,16.7,831064,269504,561560,5.9,18.2,-68850,-1.5,33.4,0,27736,27768,204908
2003,70,h) 11 to 15,252706,280050,3961271,3983040,10722,3.7,21159,7.4,589280,114793,474487,2.9,14.8,621970,198623,423347,5,15.6,-32690,-0.8,29.6,0,14439,14482,112416
2003,70,i) 16 to 20,227636,270270,4921670,4916820,9497,3.5,15152,5.5,559216,121865,437351,2.5,11.4,540239,134856,405383,2.7,11,18977,0.4,22,0,9646,10068,72012
2003,70,j) 21 to 25,148755,188145,3424812,3402526,6372,3.3,10554,5.5,428175,90014,338161,2.6,12.6,379148,92391,286757,2.7,11.1,49027,1.5,22.2,0,6432,6467,40877
2003,70,k) 26+,28530,60382,1641693,1643035,3028,5,2781,4.6,218626,46477,172149,2.8,13.3,220339,42509,177830,2.6,13.4,-1713,-0.1,26.6,0,1039,1121,5762
2003,70,l) Left Censored,257535,454608,17215315,17203666,19819,4.3,23179,5.1,1948413,433497,1514916,2.5,11.3,1898346,452558,1445788,2.6,11,50067,0.3,22,0,8770,9419,79072
2004,07,a) 0,11781,11786,52417,26209,11700,198.5,0,0,52197,52197,0,199.2,199.2,0,0,0,0,0,52197,199.2,0,0,,,
2004,07,b) 1,7928,7937,47394,48760,6,0.1,2654,28.2,15157,27,15130,0.1,31.1,17080,8677,8403,17.8,35,-1923,-3.9,62.2,0,1500,1500,5067
2004,07,c) 2,7508,7524,45687,48241,514,6.4,1468,18.3,11639,2218,9421,4.6,24.1,16268,10273,5995,21.3,33.7,-4629,-9.6,48.2,0,921,921,7696
2004,07,d) 3,6703,6776,48193,48357,480,6.8,984,13.9,12742,2796,9946,5.8,26.3,12770,7032,5738,14.5,26.4,-28,-0.1,52.6,0,621,621,5455
2004,07,e) 4,6174,6231,49934,49094,421,6.5,921,14.2,10521,1804,8717,3.7,21.4,8629,3555,5074,7.2,17.6,1892,3.8,35.2,0,529,529,2201
2004,07,f) 5,5524,5609,44011,43715,320,5.5,722,12.4,9529,1485,8044,3.4,21.8,8363,3212,5151,7.3,19.1,1166,2.7,38.2,0,441,441,1987
2004,07,g) 6 to 10,20990,21658,202114,205299,1179,5.3,2306,10.3,34439,6129,28310,3,16.8,39480,14714,24766,7.2,19.2,-5041,-2.4,33.6,0,1343,1343,7918
2004,07,h) 11 to 15,16111,16326,174761,172775,891,5.3,1508,9,34340,5658,28682,3.3,19.9,29995,10670,19325,6.2,17.4,4345,2.5,34.8,0,819,819,6239
2004,07,i) 16 to 20,10519,10594,112985,112638,384,3.5,795,7.3,15938,1775,14163,1.6,14.1,14849,4155,10694,3.7,13.2,1089,0.9,26.4,0,462,462,2832
2004,07,j) 21 to 25,6415,6847,84284,83021,362,5.3,419,6.1,13105,3623,9482,4.4,15.8,10472,2393,8079,2.9,12.6,2633,3.2,25.2,0,266,266,1672
2004,07,k) 26+,2033,2083,25052,24927,67,3.2,136,6.4,3176,320,2856,1.3,12.7,2794,711,2083,2.9,11.2,382,1.5,22.4,0,87,87,505
2004,07,l) Left Censored,5972,7400,151697,151609,221,2.9,567,7.5,18523,3475,15048,2.3,12.2,18230,5519,12711,3.6,12,293,0.2,24,0,250,250,1556
2004,10,a) 0,1283,1286,12190,6095,1279,198.9,0,0,12166,,,,199.6,0,0,0,0,0,12166,199.6,0,1,,,
2004,10,b) 1,939,951,10533,10519,6,0.6,176,16.8,2876,,,,27.3,2792,1755,1037,16.7,26.5,84,0.8,53,1,125,125,1221
2004,10,c) 2,1013,1026,13926,13695,39,3.6,178,16.2,3700,175,3525,1.3,27,3262,1624,1638,11.9,23.8,438,3.2,47.6,0,148,148,1499
2004,10,d) 3,900,914,9288,9061,38,4,102,10.7,2123,278,1845,3.1,23.4,1643,836,807,9.2,18.1,480,5.3,36.2,0,80,80,563
2004,10,e) 4,688,702,6586,6558,25,3.4,92,12.5,1170,73,1097,1.1,17.8,1086,576,510,8.8,16.6,84,1.2,33.2,0,68,68,370
2004,10,f) 5,598,610,7904,7860,23,3.6,62,9.8,1191,54,1137,0.7,15.2,1083,558,525,7.1,13.8,108,1.4,27.6,0,47,47,498
2004,10,g) 6 to 10,2709,2947,34499,33789,121,4,233,7.7,6659,963,5696,2.9,19.7,5158,1525,3633,4.5,15.3,1501,4.4,30.6,0,163,165,1204
2004,10,h) 11 to 15,2210,2368,32008,31972,118,4.9,182,7.6,5622,1106,4516,3.5,17.6,5401,1966,3435,6.1,16.9,221,0.7,33.8,0,122,122,1140
2004,10,i) 16 to 20,1840,2002,26311,25742,71,3.5,141,6.9,3997,1013,2984,3.9,15.5,2816,851,1965,3.3,10.9,1181,4.6,21.8,0,101,101,723
2004,10,j) 21 to 25,1811,2069,32158,31697,78,3.7,145,6.9,4357,998,3359,3.1,13.7,3439,1298,2141,4.1,10.8,918,2.9,21.6,0,84,84,673
2004,10,k) 26+,491,866,21291,21779,25,2.8,101,11.1,2948,483,2465,2.2,13.5,3907,1125,2782,5.2,17.9,-959,-4.4,27,0,29,29,120
2004,10,l) Left Censored,2577,5997,258267,257211,299,4.9,385,6.4,32322,9855,22467,3.8,12.6,29863,9677,20186,3.8,11.6,2459,1,23.2,0,86,86,648
2004,15,a) 0,41273,41278,172402,86201,40946,198.4,0,0,171533,171533,0,199,199,0,0,0,0,0,171533,199,0,0,,,
2004,15,b) 1,29614,29646,175193,185095,10,0,12422,34.1,56533,201,56332,0.1,30.5,72741,45465,27276,24.6,39.3,-16208,-8.8,61,0,9530,9530,37631
2004,15,c) 2,33455,33509,218378,224283,2006,5.5,7843,21.4,56594,7146,49448,3.2,25.2,66699,34239,32460,15.3,29.7,-10105,-4.5,50.4,0,5933,5933,28208
2004,15,d) 3,32805,32842,215142,218796,1785,5.1,5584,16,50983,5567,45416,2.5,23.3,56483,24909,31574,11.4,25.8,-5500,-2.5,46.6,0,4088,4089,20540
2004,15,e) 4,30788,30866,224225,226410,1801,5.6,4608,14.2,50783,6138,44645,2.7,22.4,53846,20833,33013,9.2,23.8,-3063,-1.4,44.8,0,3321,3321,17232
2004,15,f) 5,28722,28832,222624,224785,1536,5.1,4104,13.6,49865,6139,43726,2.7,22.2,52806,21798,31008,9.7,23.5,-2941,-1.3,44.4,0,2882,2882,15296
2004,15,g) 6 to 10,117206,117604,1043376,1046898,5445,4.5,13733,11.2,204200,19073,185127,1.8,19.5,206866,68969,137897,6.6,19.8,-2666,-0.3,39,0,9475,9475,53733
2004,15,h) 11 to 15,77403,77703,839117,836828,3174,4,7470,9.3,150807,15614,135193,1.9,18,143418,41053,102365,4.9,17.1,7389,0.9,34.2,0,4939,4939,32425
2004,15,i) 16 to 20,60934,61380,785522,786349,2271,3.6,5157,8.2,126217,11433,114784,1.5,16.1,125102,31000,94102,3.9,15.9,1115,0.2,31.8,0,3330,3330,20162
2004,15,j) 21 to 25,34990,35575,542841,544568,1078,3,2779,7.6,81057,6014,75043,1.1,14.9,82769,15962,66807,2.9,15.2,-1712,-0.3,29.8,0,1810,1810,11490
2004,15,k) 26+,13112,13449,212683,213076,442,3.2,1114,8.1,30601,2556,28045,1.2,14.4,31165,6559,24606,3.1,14.6,-564,-0.2,28.8,0,726,726,4138
2004,15,l) Left Censored,44789,49964,1489656,1507236,1016,2,3385,6.6,198554,14147,184407,0.9,13.2,232056,38914,193142,2.6,15.4,-33502,-2.2,26.4,0,2209,2213,17339
2004,20,a) 0,17611,17706,187476,93738,17627,199.1,0,0,186879,186879,0,199.4,199.4,0,0,0,0,0,186879,199.4,0,0,,,
2004,20,b) 1,13675,13776,183368,199536,29,0.2,3180,20.5,40920,466,40454,0.2,20.5,70858,46245,24613,23.2,35.5,-29938,-15,41,0,2548,2548,41026
2004,20,c) 2,12504,12623,176969,187527,413,3,2407,17.6,33825,5638,28187,3,18,54754,36121,18633,19.3,29.2,-20929,-11.2,36,0,2029,2029,31494
2004,20,d) 3,11846,11958,141263,145045,447,3.5,1936,15.2,23694,2922,20772,2,16.3,30158,15962,14196,11,20.8,-6464,-4.5,32.6,0,1619,1619,14331
2004,20,e) 4,11300,11525,147845,149866,429,3.5,1718,14.1,24562,3495,21067,2.3,16.4,28068,13063,15005,8.7,18.7,-3506,-2.3,32.8,0,1353,1370,10994
2004,20,f) 5,10475,10818,164644,166990,341,3,1347,11.9,23879,4468,19411,2.7,14.3,28126,12099,16027,7.2,16.8,-4247,-2.5,28.6,0,1090,1091,9854
2004,20,g) 6 to 10,45157,46404,744792,757408,1434,3,4815,10,104492,18743,85749,2.5,13.8,127874,53014,74860,7,16.9,-23382,-3.1,27.6,0,3832,3832,41357
2004,20,h) 11 to 15,34922,36212,760490,764085,948,2.5,2909,7.8,95544,18095,77449,2.4,12.5,101462,31177,70285,4.1,13.3,-5918,-0.8,25,0,2281,2284,22734
2004,20,i) 16 to 20,30433,32928,1064109,1078466,786,2.3,2272,6.7,106997,19016,87981,1.8,9.9,133896,37495,96401,3.5,12.4,-26899,-2.5,19.8,0,1699,1699,20914
2004,20,j) 21 to 25,23150,26719,1023555,1040598,598,2.2,1689,6.2,95667,17974,77693,1.7,9.2,129154,30602,98552,2.9,12.4,-33487,-3.2,18.4,0,1174,1180,15117
2004,20,k) 26+,8530,10731,542146,548191,236,2.2,586,5.4,47887,9455,38432,1.7,8.7,59218,16560,42658,3,10.8,-11331,-2.1,17.4,0,395,398,6857
2004,20,l) Left Censored,53644,98201,10095091,10247751,2465,2.5,4625,4.7,737456,131838,605618,1.3,7.2,1036244,237394,798850,2.3,10.1,-298788,-2.9,14.4,0,2139,2161,39562
2004,40,a) 0,21585,21680,120793,60397,21582,199.1,0,0,119006,119006,0,197,197,0,0,0,0,0,119006,197,0,0,,,
2004,40,b) 1,15624,15793,118942,120767,52,0.3,5146,27.7,32831,868,31963,0.7,27.2,34590,21455,13135,17.8,28.6,-1759,-1.4,54.4,0,4075,4075,18773
2004,40,c) 2,13209,13812,118222,120753,538,3.6,3023,20,27666,3540,24126,2.9,22.9,31903,15972,15931,13.2,26.4,-4237,-3.5,45.8,0,2503,2503,13785
2004,40,d) 3,11866,12225,104842,106329,561,4.3,2295,17.4,19746,2322,17424,2.2,18.6,22093,10830,11263,10.2,20.8,-2347,-2.2,37.2,0,1853,1853,8892
2004,40,e) 4,11113,11619,105478,107065,542,4.4,1830,14.9,18688,3589,15099,3.4,17.5,21535,9190,12345,8.6,20.1,-2847,-2.6,35,0,1450,1450,7651
2004,40,f) 5,9954,10948,129734,130161,462,4,1565,13.6,20768,2668,18100,2,16,21162,9248,11914,7.1,16.3,-394,-0.3,32,0,1197,1202,7726
2004,40,g) 6 to 10,37052,40534,462375,463058,1650,3.9,4963,11.7,80560,19855,60705,4.3,17.4,80236,33640,46596,7.3,17.3,324,0.1,34.6,0,3820,3836,24332
2004,40,h) 11 to 15,22743,26136,365940,378793,995,3.7,3075,11.3,52821,10683,42138,2.8,13.9,76884,42008,34876,11.1,20.3,-24063,-6.4,27.8,0,1818,1820,12811
2004,40,i) 16 to 20,15759,22695,517644,529882,930,4,2366,10.1,58286,10205,48081,1.9,11,81651,23435,58216,4.4,15.4,-23365,-4.4,22,0,1123,1124,7778
2004,40,j) 21 to 25,9743,26304,611203,618579,2621,10,2321,8.9,93129,24763,68366,4,15.1,106963,32589,74374,5.3,17.3,-13834,-2.2,30.2,0,648,648,5724
2004,40,k) 26+,3548,10855,360950,367200,756,7.1,439,4.1,46185,25536,20649,7,12.6,58460,18730,39730,5.1,15.9,-12275,-3.3,25.2,0,202,207,12471
2004,40,l) Left Censored,17309,80641,3562050,3584511,8419,10.5,7602,9.5,506717,166502,340215,4.6,14.1,537308,168407,368901,4.7,15,-30591,-0.9,28.2,0,753,774,8630
2004,50,a) 0,26113,26268,131890,65945,26167,199.2,0,0,131508,131508,0,199.4,199.4,0,0,0,0,0,131508,199.4,0,0,,,
2004,50,b) 1,20714,20935,112862,119843,91,0.4,5171,21.8,27744,917,26827,0.8,23.2,39834,25678,14156,21.4,33.2,-12090,-10,46.4,0,4071,4076,22280
2004,50,c) 2,19306,21095,173192,175066,605,2.7,3244,14.4,27218,2254,24964,1.3,15.5,30506,13973,16533,8,17.4,-3288,-1.9,31,0,2698,2698,12398
2004,50,d) 3,15475,16070,115293,116169,535,3.1,2438,14.3,20663,2084,18579,1.8,17.8,22091,10454,11637,9,19,-1428,-1.2,35.6,0,1955,1955,8374
2004,50,e) 4,14598,15263,122565,124845,497,3.1,2025,12.6,20275,2443,17832,2,16.2,24527,10920,13607,8.7,19.6,-4252,-3.4,32.4,0,1605,1606,8512
2004,50,f) 5,13843,14657,119552,120821,456,3,1764,11.5,18136,2411,15725,2,15,20309,8818,11491,7.3,16.8,-2173,-1.8,30,0,1327,1327,6569
2004,50,g) 6 to 10,61509,64230,567751,575461,2004,3,6521,9.8,78637,10128,68509,1.8,13.7,92515,35338,57177,6.1,16.1,-13878,-2.4,27.4,0,4979,4985,25260
2004,50,h) 11 to 15,46180,49136,550697,549319,1314,2.6,3880,7.7,78651,20239,58412,3.7,14.3,74237,25678,48559,4.7,13.5,4414,0.8,27,0,2871,2872,18255
2004,50,i) 16 to 20,37160,45133,654394,655922,1270,2.8,2900,6.3,71902,13804,58098,2.1,11,74058,23367,50691,3.6,11.3,-2156,-0.3,22,0,1984,2004,14881
2004,50,j) 21 to 25,27060,35192,578381,584152,960,2.7,2130,5.9,66639,12834,53805,2.2,11.4,77420,21327,56093,3.7,13.3,-10781,-1.9,22.8,0,1295,1309,10600
2004,50,k) 26+,10042,16857,320724,322096,355,2.1,767,4.5,27830,5388,22442,1.7,8.6,30324,8460,21864,2.6,9.4,-2494,-0.8,17.2,0,382,391,2894
2004,50,l) Left Censored,53102,134043,3462855,3462279,6383,4.8,6751,5,416102,114480,301622,3.3,12,412890,127742,285148,3.7,11.9,3212,0.1,23.8,0,1999,2072,22066
2004,52,a) 0,112778,113942,872442,436221,113529,199.3,0,0,870893,870893,0,199.6,199.6,0,0,0,0,0,870893,199.6,0,0,,,
2004,52,b) 1,82016,84297,737231,787228,439,0.5,24043,24.8,165010,4733,160277,0.6,21,258162,137737,120425,17.5,32.8,-93152,-11.8,42,0,20161,20166,121169
2004,52,c) 2,70200,72297,667048,698274,2455,3.1,14898,18.9,112264,13877,98387,2,16.1,171585,87751,83834,12.6,24.6,-59321,-8.5,32.2,0,12577,12590,76556
2004,52,d) 3,58662,61055,572620,590479,2024,3.1,10734,16.4,93666,13259,80407,2.2,15.9,127443,63187,64256,10.7,21.6,-33777,-5.7,31.8,0,8977,8980,53671
2004,52,e) 4,51856,54866,547669,567022,1852,3.2,8737,14.9,82129,12042,70087,2.1,14.5,118244,59120,59124,10.4,20.9,-36115,-6.4,29,0,7125,7137,48466
2004,52,f) 5,46183,50493,547908,565268,1655,3.1,7029,13.2,73385,11709,61676,2.1,13,106385,46513,59872,8.2,18.8,-33000,-5.8,26,0,5685,5732,36206
2004,52,g) 6 to 10,177097,195426,2187427,2231397,6612,3.2,22428,11,290894,54684,236210,2.5,13,372900,150765,222135,6.8,16.7,-82006,-3.7,26,0,17923,18008,120703
2004,52,h) 11 to 15,113691,139585,1820319,1848002,4603,3.2,12693,8.8,225557,49369,176188,2.7,12.2,276593,100502,176091,5.4,15,-51036,-2.8,24.4,0,9067,9074,70235
2004,52,i) 16 to 20,84145,118620,1935759,1941645,3746,3.1,8544,7.1,228436,57527,170909,3,11.8,238730,73912,164818,3.8,12.3,-10294,-0.5,23.6,0,5813,5984,45609
2004,52,j) 21 to 25,57094,89517,1716892,1710022,2914,3.2,5553,6.1,188278,45928,142350,2.7,11,173399,52538,120861,3.1,10.1,14879,0.9,20.2,0,3479,3589,27979
2004,52,k) 26+,22286,52058,1042326,1028127,1772,3.4,2448,4.7,147550,56897,90653,5.5,14.4,118238,23401,94837,2.3,11.5,29312,2.9,23,0,1216,1252,9049
2004,52,l) Left Censored,88827,424071,11856027,11722589,18864,4.4,20298,4.8,1472558,389667,1082891,3.3,12.6,1202544,380959,821585,3.2,10.3,270014,2.3,20.6,0,4557,4720,47362
2004,60,a) 0,48506,48681,193554,96777,48477,199.2,0,0,193149,193149,0,199.6,199.6,0,0,0,0,0,193149,199.6,0,0,,,
2004,60,b) 1,36015,36358,174054,187761,136,0.3,8645,21,46124,873,45251,0.5,24.6,71098,35029,36069,18.7,37.9,-24974,-13.3,49.2,0,6461,6461,29740
2004,60,c) 2,30269,31662,191810,196796,1207,3.6,4903,14.6,35031,4390,30641,2.2,17.8,43939,21335,22604,10.8,22.3,-8908,-4.5,35.6,0,3757,3758,16865
2004,60,d) 3,26665,28842,182958,183076,1289,4.3,3653,12.1,36744,5233,31511,2.9,20.1,36199,17583,18616,9.6,19.8,545,0.3,39.6,0,2700,2707,14814
2004,60,e) 4,23320,24979,184767,184179,1009,3.9,2865,11,32751,5192,27559,2.8,17.8,30731,12640,18091,6.9,16.7,2020,1.1,33.4,0,2134,2137,9374
2004,60,f) 5,21877,24104,174517,173768,889,3.6,2502,10,31087,4441,26646,2.6,17.9,28921,12814,16107,7.4,16.6,2166,1.3,33.2,0,1807,1812,10011
2004,60,g) 6 to 10,78851,87608,664344,672283,3961,4.4,7685,8.6,103073,19967,83106,3,15.3,116515,40370,76145,6,17.3,-13442,-2,30.6,0,5543,5564,28959
2004,60,h) 11 to 15,51731,60413,500449,505263,2053,3.3,4267,6.9,62527,11326,51201,2.2,12.4,70625,24856,45769,4.9,14,-8098,-1.6,24.8,0,2862,2882,12566
2004,60,i) 16 to 20,41935,53567,487068,489858,2128,3.9,3343,6.2,65115,18193,46922,3.7,13.3,71422,21943,49479,4.5,14.6,-6307,-1.3,26.6,0,2063,2096,9984
2004,60,j) 21 to 25,28746,37957,415566,404757,1750,4.6,2056,5.4,70850,30629,40221,7.6,17.5,48716,16760,31956,4.1,12,22134,5.5,24,0,1313,1313,6310
2004,60,k) 26+,10839,21168,277303,275042,1228,5.8,1202,5.7,39021,13097,25924,4.8,14.2,34364,10859,23505,3.9,12.5,4657,1.7,25,0,544,544,2248
2004,60,l) Left Censored,56990,240841,5011617,5032252,22457,9.2,26768,11,815574,310122,505452,6.2,16.2,854405,358026,496379,7.1,17,-38831,-0.8,32.4,0,2077,2086,16356
2004,70,a) 0,226724,227575,1338334,669167,226565,199.1,0,0,1334924,,,,199.5,0,0,0,0,0,1334924,199.5,0,1,,,
2004,70,b) 1,168300,169503,1332964,1319717,360,0.2,38658,20.2,377936,,,,28.6,334919,192300,142619,14.6,25.4,43017,3.2,50.8,1,28465,28465,161343
2004,70,c) 2,136162,138731,1288996,1288541,5064,3.4,22760,15.3,282536,31371,251165,2.4,21.9,275887,134030,141857,10.4,21.4,6649,0.5,42.8,0,17547,17549,113563
2004,70,d) 3,116686,120330,1137527,1158136,4681,3.7,16872,13.3,218298,25505,192793,2.2,18.8,254783,122805,131978,10.6,22,-36485,-3.2,37.6,0,12900,12918,106293
2004,70,e) 4,105074,109664,1160935,1167593,4299,3.7,13628,11.9,207254,28824,178430,2.5,17.8,215734,89718,126016,7.7,18.5,-8480,-0.7,35.6,0,10231,10244,63409
2004,70,f) 5,97837,103689,1174325,1191195,4033,3.7,11785,10.9,188632,23918,164714,2,15.8,219375,94620,124755,7.9,18.4,-30743,-2.6,31.6,0,8805,8827,79113
2004,70,g) 6 to 10,380723,407477,4950319,4999450,15602,3.7,38688,9.2,734551,111218,623333,2.2,14.7,819550,275433,544117,5.5,16.4,-84999,-1.7,29.4,0,28320,28355,211331
2004,70,h) 11 to 15,253580,277810,3786054,3810621,9479,3.3,21036,7.4,524994,93011,431983,2.4,13.8,564254,181580,382674,4.8,14.8,-39260,-1,27.6,0,14421,14479,107571
2004,70,i) 16 to 20,228760,272938,4949076,5016277,9065,3.3,15200,5.5,532706,118823,413883,2.4,10.6,661677,212848,448829,4.2,13.2,-128971,-2.6,21.2,0,9899,9994,64714
2004,70,j) 21 to 25,150441,189185,3473726,3488743,7026,3.7,10431,5.5,374706,76924,297782,2.2,10.7,400943,111529,289414,3.2,11.5,-26237,-0.8,21.4,0,6173,6221,40097
2004,70,k) 26+,52976,94210,2292843,2292240,3372,3.6,4221,4.5,253341,57336,196005,2.5,11.1,251321,56221,195100,2.5,11,2020,0.1,22,0,2104,2181,17152
2004,70,l) Left Censored,248899,449344,17227143,17141355,22177,4.9,22911,5.1,1839124,518237,1320887,3,10.7,1664119,428771,1235348,2.5,9.7,175005,1,19.4,0,8290,8388,69830
2005,07,a) 0,12401,12406,57704,28852,12298,198.3,0,0,57304,57304,0,198.6,198.6,0,0,0,0,0,57304,198.6,0,0,,,
2005,07,b) 1,8564,8573,54290,53335,9,0.1,2952,29,18471,44,18427,0.1,34.6,15094,9231,5863,17.3,28.3,3377,6.3,56.6,0,1708,1708,5471
2005,07,c) 2,7010,7030,42724,45069,467,6.2,1319,17.6,9971,1800,8171,4,22.1,14246,7426,6820,16.5,31.6,-4275,-9.5,44.2,0,857,857,5840
2005,07,d) 3,6820,6837,46341,46010,420,5.8,1085,15.1,11001,2079,8922,4.5,23.9,10523,4820,5703,10.5,22.9,478,1,45.8,0,690,690,3258
2005,07,e) 4,6139,6217,48629,48060,364,5.6,876,13.5,12029,2985,9044,6.2,25,10579,4528,6051,9.4,22,1450,3,44,0,534,534,2467
2005,07,f) 5,5768,5828,49946,50496,376,6.2,768,12.7,9395,1567,7828,3.1,18.6,10442,3622,6820,7.2,20.7,-1047,-2.1,37.2,0,431,431,1978
2005,07,g) 6 to 10,21743,22133,235904,216020,1105,4.8,2365,10.4,79588,12399,67189,5.7,36.8,39542,13180,26362,6.1,18.3,40046,18.5,36.6,0,1406,1406,8580
2005,07,h) 11 to 15,16023,16549,201955,199373,803,4.7,1522,9,43476,9960,33516,5,21.8,37945,11799,26146,5.9,19,5531,2.8,38,0,785,785,4481
2005,07,i) 16 to 20,11073,11188,115449,116936,393,3.4,836,7.3,14897,1932,12965,1.7,12.7,17516,3805,13711,3.3,15,-2619,-2.3,25.4,0,515,515,2857
2005,07,j) 21 to 25,6674,7077,89718,91536,225,3.1,418,5.8,10124,2206,7918,2.4,11.1,13516,2937,10579,3.2,14.8,-3392,-3.7,22.2,0,267,267,1948
2005,07,k) 26+,3106,3252,37816,38398,93,2.8,192,5.8,4311,642,3669,1.7,11.2,5477,1030,4447,2.7,14.3,-1166,-3.1,22.4,0,134,134,825
2005,07,l) Left Censored,5731,7191,154960,152909,292,4,480,6.6,26274,6347,19927,4.2,17.2,22000,6296,15704,4.1,14.4,4274,2.8,28.8,0,247,247,1426
2005,10,a) 0,1539,1556,12324,6162,1552,199.5,0,0,12320,12320,0,199.9,199.9,0,0,0,0,0,12320,199.9,0,0,,,
2005,10,b) 1,1069,1072,11839,11974,0,0,193,16.4,3094,0,3094,0,25.8,3302,2116,1186,17.7,27.6,-208,-1.8,51.6,0,140,140,1820
2005,10,c) 2,841,857,10488,10511,28,3.1,117,12.9,2272,397,1875,3.8,21.6,2292,869,1423,8.3,21.8,-20,-0.2,43.2,0,87,87,790
2005,10,d) 3,899,914,10777,12118,29,3,131,13.5,2495,695,1800,5.7,20.6,5130,3745,1385,30.9,42.3,-2635,-21.7,41.2,0,110,110,3650
2005,10,e) 4,825,840,9421,8846,34,3.9,101,11.6,2365,633,1732,7.2,26.7,1215,524,691,5.9,13.7,1150,13,27.4,0,79,79,404
2005,10,f) 5,636,652,6824,6638,24,3.6,68,10.1,1386,323,1063,4.9,20.9,968,296,672,4.5,14.6,418,6.3,29.2,0,51,51,222
2005,10,g) 6 to 10,2742,2809,32677,33044,107,3.7,211,7.4,5377,547,4830,1.7,16.3,6101,2571,3530,7.8,18.5,-724,-2.2,32.6,0,169,169,2030
2005,10,h) 11 to 15,2187,2499,35396,34380,101,4,179,7,6327,1285,5042,3.7,18.4,4273,1547,2726,4.5,12.4,2054,6,24.8,0,113,113,869
2005,10,i) 16 to 20,1800,1983,30869,30059,84,4.2,136,6.8,5205,1063,4142,3.5,17.3,3612,939,2673,3.1,12,1593,5.3,24,0,88,88,674
2005,10,j) 21 to 25,1859,2146,35359,34931,106,4.9,115,5.3,5210,1556,3654,4.5,14.9,4337,1422,2915,4.1,12.4,873,2.5,24.8,0,82,82,500
2005,10,k) 26+,715,1170,27003,25301,92,8,66,5.7,5713,1417,4296,5.6,22.6,2317,1259,1058,5,9.2,3396,13.4,18.4,0,29,29,102
2005,10,l) Left Censored,2489,5888,259488,258495,253,4.3,304,5.1,33333,7714,25619,3,12.9,31319,6155,25164,2.4,12.1,2014,0.8,24.2,0,105,105,712
2005,15,a) 0,39044,39088,182215,91108,38723,198.1,0,0,181000,181000,0,198.7,198.7,0,0,0,0,0,181000,198.7,0,0,,,
2005,15,b) 1,27861,27872,157768,165093,6,0,12443,36,50298,93,50205,0.1,30.5,61894,42874,19020,26,37.5,-11596,-7,61,0,9896,9896,36592
2005,15,c) 2,23927,24026,160537,167030,1407,5.2,6796,25.3,42648,5647,37001,3.4,25.5,54318,28408,25910,17,32.5,-11670,-7,51,0,5503,5503,24636
2005,15,d) 3,29191,29248,204136,211129,1592,5.1,5694,18.1,46670,6040,40630,2.9,22.1,60202,26789,33413,12.7,28.5,-13532,-6.4,44.2,0,4369,4369,22890
2005,15,e) 4,29485,29540,204922,209730,1491,4.8,4607,14.8,44179,5116,39063,2.4,21.1,53033,20449,32584,9.8,25.3,-8854,-4.2,42.2,0,3385,3385,16183
2005,15,f) 5,27939,28011,210587,217265,1311,4.5,4013,13.6,42678,4407,38271,2,19.6,55304,20332,34972,9.4,25.5,-12626,-5.9,39.2,0,2867,2867,16748
2005,15,g) 6 to 10,116572,117099,1024398,1047287,5072,4.2,13997,11.5,190792,22218,168574,2.1,18.2,232492,73132,159360,7,22.2,-41700,-4,36.4,0,9771,9772,58504
2005,15,h) 11 to 15,77713,78044,840294,854829,2877,3.6,7575,9.4,131799,12780,119019,1.5,15.4,162414,39550,122864,4.6,19,-30615,-3.6,30.8,0,5077,5079,30569
2005,15,i) 16 to 20,62005,62360,760015,777505,2078,3.2,5343,8.3,110644,9434,101210,1.2,14.2,144465,34975,109490,4.5,18.6,-33821,-4.4,28.4,0,3563,3565,25146
2005,15,j) 21 to 25,35257,35908,571225,578978,1008,2.7,2897,7.8,79835,6523,73312,1.1,13.8,94708,19140,75568,3.3,16.4,-14873,-2.6,27.6,0,2003,2003,13794
2005,15,k) 26+,19522,19909,313134,319566,574,2.8,1736,8.5,40673,3448,37225,1.1,12.7,53227,11525,41702,3.6,16.7,-12554,-4,25.4,0,1189,1189,8216
2005,15,l) Left Censored,42521,47560,1443195,1463707,1151,2.4,3296,6.8,195190,20705,174485,1.4,13.3,235662,49889,185773,3.4,16.1,-40472,-2.8,26.6,0,2185,2185,18607
2005,20,a) 0,17717,17834,192970,96485,17726,198.8,0,0,191874,191874,0,198.9,198.9,0,0,0,0,0,191874,198.9,0,0,,,
2005,20,b) 1,14284,14389,170912,177784,38,0.2,2984,18.6,45888,1572,44316,0.9,25.8,57588,35974,21614,20.2,32.4,-11700,-6.6,51.6,0,2358,2358,29934
2005,20,c) 2,11946,12060,159419,168553,369,2.9,1984,15.4,30609,2833,27776,1.7,18.2,45640,28413,17227,16.9,27.1,-15031,-8.9,36.4,0,1696,1696,26117
2005,20,d) 3,11140,11268,169574,171943,352,2.9,1631,13.7,29112,3345,25767,1.9,16.9,33921,16440,17481,9.6,19.7,-4809,-2.8,33.8,0,1393,1394,14908
2005,20,e) 4,10706,10824,135167,136915,357,3.1,1464,12.9,21678,2839,18839,2.1,15.8,24899,11918,12981,8.7,18.2,-3221,-2.4,31.6,0,1179,1179,10065
2005,20,f) 5,10358,10559,141782,143622,364,3.3,1231,11.2,21340,2995,18345,2.1,14.9,25062,10583,14479,7.4,17.4,-3722,-2.5,29.8,0,999,1002,9108
2005,20,g) 6 to 10,44311,45598,745701,750345,1377,2.9,4458,9.4,108357,18745,89612,2.5,14.4,116247,43785,72462,5.8,15.5,-7890,-1.1,28.8,0,3592,3593,34808
2005,20,h) 11 to 15,34102,35448,727482,735008,981,2.7,2825,7.8,86505,16221,70284,2.2,11.8,99805,29261,70544,4,13.6,-13300,-1.8,23.6,0,2243,2244,22174
2005,20,i) 16 to 20,30156,32342,1006418,1012784,743,2.2,2254,6.8,106892,18980,87912,1.9,10.6,117950,35297,82653,3.5,11.6,-11058,-1,21.2,0,1739,1744,20302
2005,20,j) 21 to 25,22908,25937,1008050,1004402,561,2.1,1625,6.1,110743,19667,91076,2,11,102740,32858,69882,3.3,10.2,8003,0.8,20.4,0,1158,1167,18276
2005,20,k) 26+,12448,15416,738993,742455,382,2.4,848,5.4,68386,11239,57147,1.5,9.2,75194,20565,54629,2.8,10.1,-6808,-0.9,18.4,0,581,582,7569
2005,20,l) Left Censored,51529,95693,9935547,9998651,2376,2.5,4239,4.4,773061,137846,635215,1.4,7.7,897095,199195,697900,2,9,-124034,-1.3,15.4,0,2005,2024,43129
2005,40,a) 0,22828,23115,126177,63089,22959,198.7,0,0,125542,125542,0,199,199,0,0,0,0,0,125542,199,0,0,,,
2005,40,b) 1,15957,16078,109693,113556,36,0.2,5177,27.4,29857,349,29508,0.3,26.3,36370,21754,14616,19.2,32,-6513,-5.7,52.6,0,4152,4152,18274
2005,40,c) 2,13296,13489,104999,109702,621,4.2,2809,19.2,22668,3046,19622,2.8,20.7,32250,19830,12420,18.1,29.4,-9582,-8.7,41.4,0,2339,2343,18006
2005,40,d) 3,11472,12141,115930,119116,476,3.7,2119,16.3,21094,2735,18359,2.3,17.7,27147,12590,14557,10.6,22.8,-6053,-5.1,35.4,0,1733,1733,10313
2005,40,e) 4,10483,10875,97932,101088,494,4.3,1768,15.3,17002,3324,13678,3.3,16.8,23326,12186,11140,12.1,23.1,-6324,-6.3,33.6,0,1415,1416,10372
2005,40,f) 5,9943,10500,100371,103008,473,4.3,1504,13.6,17346,3884,13462,3.8,16.8,22029,11357,10672,11,21.4,-4683,-4.6,33.6,0,1172,1172,9867
2005,40,g) 6 to 10,37539,41696,475025,491600,1749,4,4860,11.2,67419,13330,54089,2.7,13.7,100053,40509,59544,8.2,20.4,-32634,-6.7,27.4,0,3683,3689,32931
2005,40,h) 11 to 15,23216,25781,353578,358206,1193,4.5,2400,9.1,48360,9492,38868,2.6,13.5,57241,19307,37934,5.4,16,-8881,-2.5,27,0,1777,1791,14977
2005,40,i) 16 to 20,16162,22226,493878,487079,1501,6.7,1966,8.8,85689,42646,43043,8.8,17.6,72311,31811,40500,6.5,14.8,13378,2.8,29.6,0,1087,1090,9247
2005,40,j) 21 to 25,9824,27154,646917,660926,2031,7.4,2450,8.9,72377,18388,53989,2.8,11,100057,22749,77308,3.4,15.1,-27680,-4.1,22,0,586,632,3935
2005,40,k) 26+,5162,14007,442955,432312,715,5,1320,9.2,61554,16646,44908,3.9,14.2,40333,12823,27510,3,9.3,21221,4.9,18.6,0,248,322,3630
2005,40,l) Left Censored,16695,80042,3487476,3514922,6631,8.3,6373,8,395858,151681,244177,4.3,11.3,463083,122105,340978,3.5,13.2,-67225,-1.9,22.6,0,678,688,10547
2005,50,a) 0,26103,26291,124442,62221,26139,198.8,0,0,123969,123969,0,199.2,199.2,0,0,0,0,0,123969,199.2,0,0,,,
2005,50,b) 1,20423,20676,115994,123790,110,0.5,5232,22.3,29095,529,28566,0.4,23.5,43049,23447,19602,18.9,34.8,-13954,-11.3,47,0,4262,4262,20593
2005,50,c) 2,18009,18294,105626,108597,626,3.2,3171,16.2,21301,2072,19229,1.9,19.6,26774,13861,12913,12.8,24.7,-5473,-5.1,39.2,0,2637,2637,11999
2005,50,d) 3,17267,19079,169654,170776,576,2.9,2499,12.4,25214,2209,23005,1.3,14.8,27082,12548,14534,7.3,15.9,-1868,-1.1,29.6,0,2004,2004,10040
2005,50,e) 4,13971,14598,113071,113852,533,3.5,1917,12.5,19920,3319,16601,2.9,17.5,21136,8724,12412,7.7,18.6,-1216,-1.1,35,0,1529,1529,6899
2005,50,f) 5,13267,13943,119564,120570,480,3.3,1700,11.7,20378,4399,15979,3.6,16.9,22102,8712,13390,7.2,18.3,-1724,-1.4,33.8,0,1338,1347,6938
2005,50,g) 6 to 10,59878,62918,556886,566389,2089,3.2,6304,9.7,77260,10542,66718,1.9,13.6,94754,36022,58732,6.4,16.7,-17494,-3.1,27.2,0,4795,4823,29285
2005,50,h) 11 to 15,45883,48769,541921,546896,1362,2.7,3877,7.7,67958,8975,58983,1.6,12.4,77665,25286,52379,4.6,14.2,-9707,-1.8,24.8,0,2877,2877,17756
2005,50,i) 16 to 20,37083,43696,630086,632528,1228,2.8,2786,6.3,74217,13788,60429,2.2,11.7,78224,26069,52155,4.1,12.4,-4007,-0.7,23.4,0,1932,1935,15700
2005,50,j) 21 to 25,27290,35758,589654,593313,886,2.4,1910,5.3,61997,10754,51243,1.8,10.4,69037,18093,50944,3,11.6,-7040,-1.2,20.8,0,1238,1238,9342
2005,50,k) 26+,14318,24174,441355,442475,1106,4.6,1183,4.9,52258,17926,34332,4.1,11.8,54392,14536,39856,3.3,12.3,-2134,-0.5,23.6,0,643,651,7143
2005,50,l) Left Censored,50861,133563,3447277,3437159,7369,5.5,5887,4.4,422650,150702,271948,4.4,12.3,400423,111610,288813,3.2,11.6,22227,0.7,23.2,0,1971,1996,21207
2005,52,a) 0,118100,119810,951603,475802,119195,199,0,0,948829,948829,0,199.4,199.4,0,0,0,0,0,948829,199.4,0,0,,,
2005,52,b) 1,85808,87518,741044,804834,609,0.6,25015,24.8,153305,8295,145010,1,19,271637,148977,122660,18.5,33.8,-118332,-14.8,38,0,21521,21529,134491
2005,52,c) 2,68485,71060,628644,681057,2713,3.5,15283,19.7,101240,18134,83106,2.7,14.9,202876,105586,97290,15.5,29.8,-101636,-14.9,29.8,0,13418,13418,95083
2005,52,d) 3,60872,63123,592314,629218,2223,3.3,11105,16.4,85764,12436,73328,2,13.6,157977,76203,81774,12.1,25.1,-72213,-11.5,27.2,0,9580,9580,68231
2005,52,e) 4,51722,54249,516746,543611,2017,3.5,8489,14.7,73912,11774,62138,2.2,13.6,126491,58445,68046,10.8,23.3,-52579,-9.7,27.2,0,7179,7221,52009
2005,52,f) 5,46330,49342,502717,524552,1639,3.1,6865,13.2,66101,10459,55642,2,12.6,108244,45219,63025,8.6,20.6,-42143,-8,25.2,0,5743,5748,38331
2005,52,g) 6 to 10,177205,197389,2170597,2253963,7081,3.4,22445,10.9,271650,53012,218638,2.4,12.1,434186,157929,276257,7,19.3,-162536,-7.2,24.2,0,18667,18733,131034
2005,52,h) 11 to 15,113529,134014,1690122,1737656,4480,3.2,12036,8.7,202363,50690,151673,2.9,11.6,295309,94999,200310,5.5,17,-92946,-5.4,23.2,0,9512,9538,74469
2005,52,i) 16 to 20,84037,119664,1835235,1867299,4053,3.3,9039,7.4,215260,57844,157416,3.1,11.5,278421,78628,199793,4.2,14.9,-63161,-3.4,23,0,6129,6199,49579
2005,52,j) 21 to 25,56984,90722,1529929,1556415,2806,3,5493,6,148982,39978,109004,2.6,9.6,200252,64702,135550,4.2,12.9,-51270,-3.3,19.2,0,3649,3682,47398
2005,52,k) 26+,31192,71406,1678927,1650139,3368,4.7,3111,4.4,228822,75694,153128,4.6,13.9,171638,33730,137908,2,10.4,57184,3.5,20.8,0,1792,1863,15429
2005,52,l) Left Censored,84155,421156,11969284,11851370,22037,5.3,14399,3.5,1381851,560681,821170,4.7,11.7,1147205,196370,950835,1.7,9.7,234646,2,19.4,0,4532,4741,42112
2005,60,a) 0,53313,54980,227806,113903,54637,198.8,0,0,226981,226981,0,199.3,199.3,0,0,0,0,0,226981,199.3,0,0,,,
2005,60,b) 1,38281,38601,179655,185199,163,0.4,9286,21.3,48091,773,47318,0.4,26,56419,34175,22244,18.5,30.5,-8328,-4.5,52,0,6741,6741,27579
2005,60,c) 2,31570,31986,162211,166639,1220,3.6,5261,15.4,35288,4177,31111,2.5,21.2,42486,21499,20987,12.9,25.5,-7198,-4.3,42.4,0,4090,4090,18749
2005,60,d) 3,27250,28707,183088,185459,1166,3.9,3913,13,33619,5205,28414,2.8,18.1,37854,16552,21302,8.9,20.4,-4235,-2.3,36.2,0,2968,2968,13227
2005,60,e) 4,24490,26883,165611,172985,1177,4.2,2979,10.7,27096,4305,22791,2.5,15.7,32620,11995,20625,6.9,18.9,-5524,-3.2,31.4,0,2256,2257,9741
2005,60,f) 5,21551,23227,165962,174563,939,3.9,2511,10.4,24248,4379,19869,2.5,13.9,41500,15070,26430,8.6,23.8,-17252,-9.9,27.8,0,1913,1930,11718
2005,60,g) 6 to 10,82177,93262,680306,694241,4560,4.8,8409,8.8,104890,25043,79847,3.6,15.1,131008,48581,82427,7,18.9,-26118,-3.8,30.2,0,5974,5993,36065
2005,60,h) 11 to 15,52890,60832,494876,502132,2389,3.9,4355,7,65488,17052,48436,3.4,13,78732,26767,51965,5.3,15.7,-13244,-2.7,26,0,3150,3150,18512
2005,60,i) 16 to 20,41853,53072,481556,485357,3298,6.2,3485,6.5,65627,24126,41501,5,13.5,72929,22463,50466,4.6,15,-7302,-1.5,27,0,2193,2210,14524
2005,60,j) 21 to 25,29407,41989,448391,454380,2036,4.8,2239,5.3,54979,18121,36858,4,12.1,66768,18546,48222,4.1,14.7,-11789,-2.6,24.2,0,1402,1402,6892
2005,60,k) 26+,15501,28018,351197,345202,1872,6.7,1487,5.3,53550,27912,25638,8.1,15.5,41430,13584,27846,3.9,12,12120,3.5,24,0,769,769,3528
2005,60,l) Left Censored,54764,238827,4892922,4940896,28569,12,27145,11.4,756196,358708,397488,7.3,15.3,852144,381823,470321,7.7,17.2,-95948,-1.9,30.6,0,2114,2184,19762
2005,70,a) 0,241868,243872,1470536,735268,242282,198.7,0,0,1462514,1462514,0,198.9,198.9,0,0,0,0,0,1462514,198.9,0,0,,,
2005,70,b) 1,181137,182356,1346010,1333237,433,0.2,40674,19.8,392612,6023,386589,0.5,29.4,350561,186122,164439,14,26.3,42051,3.1,52.6,0,29730,29730,154688
2005,70,c) 2,149381,150794,1275037,1286228,5776,3.6,23113,14.4,280920,26012,254908,2,21.8,299286,144744,154542,11.3,23.3,-18366,-1.5,43.6,0,17772,17814,124890
2005,70,d) 3,123100,125884,1219776,1245327,4722,3.6,16873,12.8,211168,25193,185975,2,17,261574,116956,144618,9.4,21,-50406,-4,34,0,13260,13271,95089
2005,70,e) 4,107031,110889,1114169,1119678,4519,3.9,13221,11.4,205815,26341,179474,2.4,18.4,214161,85206,128955,7.6,19.1,-8346,-0.7,36.8,0,10223,10233,68646
2005,70,f) 5,96963,101754,1138025,1145291,3991,3.8,11327,10.7,181191,24255,156936,2.1,15.8,193124,72235,120889,6.3,16.9,-11933,-1.1,31.6,0,8548,8566,59490
2005,70,g) 6 to 10,390555,421470,5173777,5229681,16677,3.8,39129,9,796622,169335,627287,3.2,15.2,898336,335180,563156,6.4,17.2,-101714,-2,30.4,0,28922,28995,249626
2005,70,h) 11 to 15,257108,281025,3800115,3797729,10765,3.8,21181,7.4,563792,126274,437518,3.3,14.8,564538,168500,396038,4.4,14.9,-746,-0.1,29.6,0,14962,15001,107350
2005,70,i) 16 to 20,207539,249364,4736179,4765929,8299,3.3,15052,5.9,462328,94472,367856,2,9.7,518841,142847,375994,3,10.9,-56513,-1.2,19.4,0,9883,10026,79479
2005,70,j) 21 to 25,174739,215194,3773958,3797190,6238,2.9,10754,4.9,403473,88074,315399,2.3,10.6,446487,113350,333137,3,11.8,-43014,-1.2,21.2,0,6789,6822,64491
2005,70,k) 26+,76337,126175,2827237,2818940,4752,3.7,6063,4.8,348021,111581,236440,4,12.3,329978,65088,264890,2.3,11.7,18043,0.6,23.4,0,3087,3105,21628
2005,70,l) Left Censored,240327,443958,17393642,17322713,21555,4.9,21504,4.8,1814158,485269,1328889,2.8,10.5,1670358,440176,1230182,2.5,9.6,143800,0.9,19.2,0,8393,8453,117961
2006,07,a) 0,13919,13952,65934,32967,13753,197.1,0,0,65481,65481,0,198.6,198.6,0,0,0,0,0,65481,198.6,0,0,,,
2006,07,b) 1,9000,9011,56454,57190,7,0.1,3095,28.9,16482,63,16419,0.1,28.8,16746,10509,6237,18.4,29.3,-264,-0.5,57.6,0,1950,1950,6536
2006,07,c) 2,7494,7510,46026,50041,469,5.8,1462,18.2,10728,1268,9460,2.5,21.4,18445,9154,9291,18.3,36.9,-7717,-15.5,42.8,0,924,924,7553
2006,07,d) 3,6226,6255,43490,43104,359,5.4,1117,16.8,9902,1360,8542,3.2,23,9171,4200,4971,9.7,21.3,731,1.7,42.6,0,724,724,3134
2006,07,e) 4,6260,6281,48002,47132,395,6,929,14.2,11045,1488,9557,3.2,23.4,9024,3662,5362,7.8,19.1,2021,4.3,38.2,0,589,589,2375
2006,07,f) 5,5661,5740,47199,47884,337,5.6,786,13.2,10404,1685,8719,3.5,21.7,11503,4750,6753,9.9,24,-1099,-2.3,43.4,0,482,482,3357
2006,07,g) 6 to 10,22290,22708,217495,235091,1261,5.4,2584,11,50452,5957,44495,2.5,21.5,84669,12303,72366,5.2,36,-34217,-14.5,43,0,1537,1537,8357
2006,07,h) 11 to 15,15169,15803,167005,178358,834,5.2,1535,9.5,28774,6466,22308,3.6,16.1,51103,30937,20166,17.3,28.7,-22329,-12.6,32.2,0,858,860,26573
2006,07,i) 16 to 20,12412,12569,139520,139720,611,4.8,1105,8.6,22222,3490,18732,2.5,15.9,22402,5995,16407,4.3,16,-180,-0.1,31.8,0,667,667,4233
2006,07,j) 21 to 25,7166,7663,101170,99504,324,4.2,481,6.2,14466,1802,12664,1.8,14.5,10995,3330,7665,3.3,11,3471,3.5,22,0,309,309,2215
2006,07,k) 26+,3976,4082,49473,49969,117,2.8,351,8.4,5867,499,5368,1,11.7,6922,3031,3891,6.1,13.9,-1055,-2.2,23.4,0,195,195,1541
2006,07,l) Left Censored,5437,7026,151064,152712,275,3.9,461,6.5,24380,8480,15900,5.6,16,27514,5656,21858,3.7,18,-3134,-2,32,0,269,269,2326
2006,10,a) 0,2018,2075,21889,10945,2064,198.9,0,0,21790,,,,199.1,0,0,0,0,0,21790,199.1,0,1,,,
2006,10,b) 1,1302,1321,14539,13348,5,0.3,210,14.6,5447,,,,40.8,2999,1860,1139,13.9,22.5,2448,18.3,45,1,162,162,1731
2006,10,c) 2,943,949,12715,11866,32,3.2,145,14.4,3439,218,3221,1.8,29,1680,1000,680,8.4,14.2,1759,14.8,28.4,0,117,117,916
2006,10,d) 3,756,776,10345,10425,30,3.7,102,12.5,2705,244,2461,2.3,25.9,2641,1755,886,16.8,25.3,64,0.6,50.6,0,69,69,1429
2006,10,e) 4,794,809,10944,10682,19,2.2,111,12.9,2482,79,2403,0.7,23.2,1914,1230,684,11.5,17.9,568,5.3,35.8,0,83,83,1079
2006,10,f) 5,776,787,10789,9941,44,5.4,86,10.6,3374,301,3073,3,33.9,1703,711,992,7.2,17.1,1671,16.8,34.2,0,62,63,634
2006,10,g) 6 to 10,2713,2856,41824,38143,141,4.8,252,8.6,12017,2009,10008,5.3,31.5,4570,1680,2890,4.4,12,7447,19.5,24,0,175,175,1369
2006,10,h) 11 to 15,2151,2450,33020,31707,169,6.9,186,7.6,6049,1516,4533,4.8,19.1,3389,1117,2272,3.5,10.7,2660,8.4,21.4,0,128,128,840
2006,10,i) 16 to 20,1767,1961,39053,36716,90,4.5,152,7.6,8408,2651,5757,7.2,22.9,3702,1920,1782,5.2,10.1,4706,12.8,20.2,0,100,100,1096
2006,10,j) 21 to 25,1882,2135,36490,35232,84,3.9,158,7.3,6656,1298,5358,3.7,18.9,4118,2021,2097,5.7,11.7,2538,7.2,23.4,0,93,93,1232
2006,10,k) 26+,969,1487,33774,32910,81,5.5,58,3.9,5417,1674,3743,5.1,16.5,3643,793,2850,2.4,11.1,1774,5.4,22.2,0,41,42,473
2006,10,l) Left Censored,2401,6101,277358,270054,483,8,335,5.6,43740,13709,30031,5.1,16.2,28759,12204,16555,4.5,10.6,14981,5.6,21.2,0,82,82,1854
2006,15,a) 0,40315,40418,191471,95736,39959,197.7,0,0,190045,190045,0,198.5,198.5,0,0,0,0,0,190045,198.5,0,0,,,
2006,15,b) 1,29029,29081,187267,184311,12,0,9150,26.8,60508,261,60247,0.1,32.8,52559,29150,23409,15.8,28.5,7949,4.3,57,0,6870,6870,23193
2006,15,c) 2,24156,24171,154939,155427,1167,4.5,4769,18.3,40896,3780,37116,2.4,26.3,41807,20769,21038,13.4,26.9,-911,-0.6,52.6,0,3516,3516,16577
2006,15,d) 3,20240,20363,156125,157821,1032,4.6,4654,21,38211,3529,34682,2.2,24.2,41206,19940,21266,12.6,26.1,-2995,-1.9,48.4,0,3610,3610,16594
2006,15,e) 4,25706,25779,203442,203685,1295,4.7,4736,17.2,46907,4277,42630,2.1,23,47627,22778,24849,11.2,23.4,-720,-0.4,46,0,3540,3540,18817
2006,15,f) 5,26891,26932,213234,210552,1264,4.5,3834,13.6,47519,4722,42797,2.2,22.6,42268,15776,26492,7.5,20.1,5251,2.5,40.2,0,2640,2659,12389
2006,15,g) 6 to 10,114519,115139,1042488,1038158,4938,4.1,13788,11.5,205391,18697,186694,1.8,19.8,196116,67306,128810,6.5,18.9,9275,0.9,37.8,0,9437,9442,48495
2006,15,h) 11 to 15,78712,79042,877473,873419,2847,3.5,7649,9.4,151906,12012,139894,1.4,17.4,143648,36677,106971,4.2,16.4,8258,1,32.8,0,5158,5158,28564
2006,15,i) 16 to 20,62572,63004,795952,789065,2232,3.4,5495,8.5,130856,12251,118605,1.6,16.6,116420,27664,88756,3.5,14.8,14436,1.8,29.6,0,3674,3674,20847
2006,15,j) 21 to 25,37183,37745,624473,616850,1132,2.9,2949,7.6,100102,7995,92107,1.3,16.2,84150,19763,64387,3.2,13.6,15952,2.6,27.2,0,1977,1977,13850
2006,15,k) 26+,24838,25459,422857,421903,790,3,2239,8.5,62552,5142,57410,1.2,14.8,60381,15689,44692,3.7,14.3,2171,0.5,28.6,0,1461,1461,9286
2006,15,l) Left Censored,40444,45388,1479862,1460686,1076,2.3,3093,6.7,223919,18376,205543,1.3,15.3,185192,38316,146876,2.6,12.7,38727,2.6,25.4,0,1972,2013,18763
2006,20,a) 0,18169,18412,208215,104108,18264,198.4,0,0,206931,206931,0,198.8,198.8,0,0,0,0,0,206931,198.8,0,0,,,
2006,20,b) 1,14225,14384,178101,186119,65,0.4,3160,19.6,44646,2220,42426,1.2,24,58498,39499,18999,21.2,31.4,-13852,-7.4,48,0,2522,2522,34688
2006,20,c) 2,12388,12540,165841,166254,415,3.1,2171,16.1,36541,4474,32067,2.7,22,37069,22483,14586,13.5,22.3,-528,-0.3,44,0,1763,1763,18906
2006,20,d) 3,10603,10719,153788,154466,271,2.4,1553,13.7,29852,2439,27413,1.6,19.3,30765,17322,13443,11.2,19.9,-913,-0.6,38.6,0,1260,1260,14920
2006,20,e) 4,9949,10099,168671,168920,258,2.4,1395,13.1,27953,3848,24105,2.3,16.5,28477,14273,14204,8.4,16.9,-524,-0.4,33,0,1117,1118,11690
2006,20,f) 5,9750,9878,133940,133731,333,3.2,1237,12,21742,2946,18796,2.2,16.3,21360,10418,10942,7.8,16,382,0.3,32,0,989,990,8602
2006,20,g) 6 to 10,43307,44709,737997,739613,1291,2.8,4479,9.7,104717,15691,89026,2.1,14.2,107988,43900,64088,5.9,14.6,-3271,-0.4,28.4,0,3496,3498,36790
2006,20,h) 11 to 15,33130,34418,685299,683060,896,2.5,2923,8.2,89164,13437,75727,2,13.1,84387,30572,53815,4.5,12.4,4777,0.7,24.8,0,2212,2215,24604
2006,20,i) 16 to 20,29300,31424,954189,955516,754,2.3,2249,7,107358,23653,83705,2.5,11.2,109445,35487,73958,3.7,11.5,-2087,-0.3,22.4,0,1706,1707,23532
2006,20,j) 21 to 25,23531,26524,1062921,1064574,697,2.6,1653,6.1,106419,26240,80179,2.5,10,108902,32654,76248,3.1,10.2,-2483,-0.2,20,0,1198,1201,18875
2006,20,k) 26+,15765,19332,895711,893217,497,2.5,1142,5.8,87687,19068,68619,2.1,9.8,82876,23383,59493,2.6,9.3,4811,0.5,18.6,0,790,797,10712
2006,20,l) Left Censored,49107,93526,9744213,9816686,2926,3.1,4271,4.5,740577,130391,610186,1.3,7.5,886713,202167,684546,2.1,9,-146136,-1.5,15,0,2084,2110,46082
2006,40,a) 0,23649,24114,125744,62872,23897,198.2,0,0,125096,125096,0,199,199,0,0,0,0,0,125096,199,0,0,,,
2006,40,b) 1,16636,16980,121586,123251,96,0.5,5709,28.5,32604,997,31607,0.8,26.5,34657,22202,12455,18,28.1,-2053,-1.6,53,0,4589,4589,18043
2006,40,c) 2,13318,13484,101571,104490,533,3.6,3016,20.4,22398,2209,20189,2.1,21.4,27292,16814,10478,16.1,26.1,-4894,-4.7,42.8,0,2427,2428,14031
2006,40,d) 3,11356,11581,94088,97268,421,3.4,2242,17.9,17440,1858,15582,1.9,17.9,23637,13473,10164,13.9,24.3,-6197,-6.4,35.8,0,1796,1796,11113
2006,40,e) 4,10065,10925,103428,105462,646,5.6,1801,15.7,19726,4304,15422,4.1,18.7,23865,12836,11029,12.2,22.6,-4139,-3.9,37.4,0,1390,1390,9670
2006,40,f) 5,9290,9665,94838,96155,392,3.8,1483,14.5,15799,2557,13242,2.7,16.4,18160,8201,9959,8.5,18.9,-2361,-2.5,32.8,0,1113,1114,6874
2006,40,g) 6 to 10,37490,42023,483704,488284,1902,4.4,5136,11.8,77841,13957,63884,2.9,15.9,85776,38680,47096,7.9,17.6,-7935,-1.7,31.8,0,3743,3754,31363
2006,40,h) 11 to 15,23391,26011,353904,357320,1097,4.1,2703,10.1,51508,15691,35817,4.4,14.4,57977,20961,37016,5.9,16.2,-6469,-1.8,28.8,0,1879,1880,13794
2006,40,i) 16 to 20,16574,21558,409928,409300,848,3.9,1675,7.6,56894,16762,40132,4.1,13.9,55330,13784,41546,3.4,13.5,1564,0.4,27,0,1055,1072,9704
2006,40,j) 21 to 25,10190,29342,741600,741307,3067,10.7,1841,6.4,92259,40162,52097,5.4,12.4,90885,20442,70443,2.8,12.3,1374,0.1,24.6,0,628,630,5931
2006,40,k) 26+,6490,16553,513885,502349,1298,7.9,1024,6.2,64200,18849,45351,3.8,12.8,40867,10598,30269,2.1,8.1,23333,4.7,16.2,0,342,352,3724
2006,40,l) Left Censored,16050,79730,3502268,3496841,7070,8.9,6230,7.9,450149,156463,293686,4.5,12.9,438606,119756,318850,3.4,12.5,11543,0.4,25,0,636,642,10656
2006,50,a) 0,25699,26298,134506,67253,26066,198.2,0,0,133887,133887,0,199.1,199.1,0,0,0,0,0,133887,199.1,0,0,,,
2006,50,b) 1,20525,20856,117381,121219,149,0.6,5092,21.6,30713,1598,29115,1.3,25.3,36705,22818,13887,18.8,30.3,-5992,-5,50.6,0,3968,3968,19898
2006,50,c) 2,17523,17847,113191,113616,525,2.7,3246,16.9,22356,2173,20183,1.9,19.7,25174,13834,11340,12.2,22.2,-2818,-2.5,39.4,0,2651,2651,12163
2006,50,d) 3,15864,16210,103064,103959,494,2.9,2500,14.5,19139,1736,17403,1.7,18.4,20717,10396,10321,10,19.9,-1578,-1.5,36.8,0,2049,2049,8279
2006,50,e) 4,15581,17467,164511,164039,523,2.9,2085,11.4,25196,3149,22047,1.9,15.4,24451,10558,13893,6.4,14.9,745,0.5,29.8,0,1615,1615,8855
2006,50,f) 5,12646,13309,110455,111753,425,3,1654,11.9,17902,2307,15595,2.1,16,20143,9156,10987,8.2,18,-2241,-2,32,0,1282,1283,7689
2006,50,g) 6 to 10,57505,60937,554175,557234,1984,3.1,6143,9.7,79311,11030,68281,2,14.2,85640,34548,51092,6.2,15.4,-6329,-1.2,28.4,0,4482,4488,26555
2006,50,h) 11 to 15,45078,47976,529938,533248,1423,2.9,4054,8.2,74302,11099,63203,2.1,13.9,80407,35247,45160,6.6,15.1,-6105,-1.2,27.8,0,2952,2976,21527
2006,50,i) 16 to 20,36728,42717,606876,612495,1334,3.1,2999,6.9,67016,13840,53176,2.3,10.9,77795,30169,47626,4.9,12.7,-10779,-1.8,21.8,0,2060,2060,21991
2006,50,j) 21 to 25,28233,37344,614748,620522,1138,3,2323,6.1,67503,15836,51667,2.6,10.9,78742,24972,53770,4,12.7,-11239,-1.8,21.8,0,1427,1430,15637
2006,50,k) 26+,18048,29253,547538,538088,1504,5.1,2029,6.9,79016,25548,53468,4.7,14.7,59998,22066,37932,4.1,11.2,19018,3.5,22.4,0,837,852,9030
2006,50,l) Left Censored,48407,133177,3417519,3426452,7294,5.5,6458,4.9,386930,111540,275390,3.3,11.3,404714,119271,285443,3.5,11.8,-17784,-0.5,22.6,0,1985,2026,31520
2006,52,a) 0,117102,119874,983371,491686,119115,198.7,0,0,979630,979630,0,199.2,199.2,0,0,0,0,0,979630,199.2,0,0,,,
2006,52,b) 1,88085,90461,823779,892838,743,0.7,27789,26.4,167242,9600,157642,1.1,18.7,296377,160579,135798,18,33.2,-129135,-14.5,37.4,0,23398,23403,139209
2006,52,c) 2,70284,72415,653713,695550,2248,2.8,16796,21,107928,14486,93442,2.1,15.5,188972,105202,83770,15.1,27.2,-81044,-11.7,31,0,14255,14284,92768
2006,52,d) 3,57384,60283,569139,596645,2008,3.1,12299,18.8,90658,14813,75845,2.5,15.2,144321,76734,67587,12.9,24.2,-53663,-9,30.4,0,10362,10372,66196
2006,52,e) 4,52254,54745,546562,568572,1667,2.8,9709,16.5,77280,11343,65937,2,13.6,119856,60568,59288,10.7,21.1,-42576,-7.5,27.2,0,8012,8028,50996
2006,52,f) 5,45039,47768,483071,499104,1495,2.9,7720,15.1,69163,10744,58419,2.2,13.9,100956,48247,52709,9.7,20.2,-31793,-6.3,27.8,0,6272,6288,40820
2006,52,g) 6 to 10,173339,195795,2198413,2256876,6155,3,25034,12.2,287006,53444,233562,2.4,12.7,399791,175962,223829,7.8,17.7,-112785,-5,25.4,0,19755,19779,143172
2006,52,h) 11 to 15,110904,130032,1673530,1704292,4101,3,13799,10.2,208397,48597,159800,2.9,12.2,268083,106199,161884,6.2,15.7,-59686,-3.5,24.4,0,10517,10558,79601
2006,52,i) 16 to 20,82299,119711,1831837,1826107,5490,4.5,9850,8.1,257077,89108,167969,4.9,14.1,243813,79967,163846,4.4,13.4,13264,0.7,26.8,0,6870,6912,53360
2006,52,j) 21 to 25,57655,90744,1583629,1591454,3085,3.3,6421,6.9,176378,58052,118326,3.6,11.1,191029,58302,132727,3.7,12,-14651,-0.9,22.2,0,4233,4307,36799
2006,52,k) 26+,38230,86918,2016506,1974907,4382,5,4813,5.5,298955,152310,146645,7.7,15.1,214871,54496,160375,2.8,10.9,84084,4.2,21.8,0,2510,2556,19564
2006,52,l) Left Censored,78453,416407,12107080,11982264,19101,4.6,15858,3.8,1372768,453906,918862,3.8,11.5,1121021,221072,899949,1.8,9.4,251747,2.1,18.8,0,4877,4995,47102
2006,60,a) 0,57456,59641,240117,120059,59138,198.3,0,0,239133,239133,0,199.2,199.2,0,0,0,0,0,239133,199.2,0,0,,,
2006,60,b) 1,40696,42973,189546,198237,643,1.3,11545,23.6,49913,3607,46306,1.8,25.2,64810,42469,22341,21.4,32.7,-14897,-7.5,50.4,0,8481,8483,35382
2006,60,c) 2,32887,33448,164105,167213,1444,4,6229,17.3,35916,4718,31198,2.8,21.5,41267,23500,17767,14.1,24.7,-5351,-3.2,43,0,4639,4639,18020
2006,60,d) 3,27729,28456,156846,158880,1170,3.9,4664,15.4,31271,5958,25313,3.8,19.7,34913,16306,18607,10.3,22,-3642,-2.3,39.4,0,3442,3442,13653
2006,60,e) 4,24360,26068,196349,198089,1214,4.4,3680,13.5,32248,5371,26877,2.7,16.3,35324,16129,19195,8.1,17.8,-3076,-1.5,32.6,0,2627,2632,13033
2006,60,f) 5,22083,24711,162399,165069,985,3.8,3028,11.7,27404,4457,22947,2.7,16.6,32441,16521,15920,10,19.7,-5037,-3.1,33.2,0,2188,2188,11645
2006,60,g) 6 to 10,83325,95519,727944,729931,4083,4.1,10129,10.3,113985,26599,87386,3.6,15.6,118133,52202,65931,7.2,16.2,-4148,-0.6,31.2,0,6732,6754,38514
2006,60,h) 11 to 15,52350,60395,506797,509326,2591,4.2,5605,9,76942,24213,52729,4.8,15.1,81771,34106,47665,6.7,16.1,-4829,-1,30.2,0,3679,3701,19325
2006,60,i) 16 to 20,41225,53445,477934,480879,3704,6.9,3888,7.3,70937,26068,44869,5.4,14.8,75964,26132,49832,5.4,15.8,-5027,-1,29.6,0,2392,2397,15505
2006,60,j) 21 to 25,30492,45467,495456,493029,2350,5.2,2524,5.5,60299,24744,35555,5,12.2,55309,17822,37487,3.6,11.2,4990,1,22.4,0,1520,1534,9072
2006,60,k) 26+,19561,33815,401645,399443,1981,5.8,2123,6.3,61947,25247,36700,6.3,15.5,57528,22073,35455,5.5,14.4,4419,1.1,28.8,0,1006,1017,6654
2006,60,l) Left Censored,52135,241997,4973475,4924968,24988,10.5,19026,8,794773,312741,482032,6.4,16.1,694833,271511,423322,5.5,14.1,99940,2,28.2,0,2199,2247,29823
2006,70,a) 0,250271,255119,1514703,757352,252902,198.3,0,0,1507305,,,,199,0,0,0,0,0,1507305,199,0,1,,,
2006,70,b) 1,186719,189321,1510817,1488776,699,0.3,49789,23,435859,,,,29.3,377228,221633,155595,14.9,25.3,58631,4,50.6,1,37257,37288,184135
2006,70,c) 2,156820,158464,1314072,1318220,5855,3.4,28400,16.7,295800,35147,260653,2.7,22.4,298833,152837,145996,11.6,22.7,-3033,-0.3,44.8,0,21717,21721,129356
2006,70,d) 3,133477,135261,1277077,1269972,4841,3.4,19718,13.8,266552,25306,241246,2,21,250343,116447,133896,9.2,19.7,16209,1.3,39.4,0,14644,14657,97173
2006,70,e) 4,111538,114614,1214388,1213744,3861,3.2,14574,12.1,215775,28623,187152,2.4,17.8,213965,91501,122464,7.5,17.6,1810,0.2,35.2,0,10825,10842,74106
2006,70,f) 5,97387,101454,1097804,1089669,3485,3.3,12374,11.7,192710,22255,170455,2,17.7,174866,74257,100609,6.8,16,17844,1.7,32,0,9155,9183,61803
2006,70,g) 6 to 10,390573,422965,5404487,5398667,15582,3.6,44301,10.1,830713,143415,687298,2.7,15.4,810162,329829,480333,6.1,15,20551,0.4,30,0,30951,31009,241257
2006,70,h) 11 to 15,257094,281885,3874219,3852827,9916,3.4,25006,8.6,588028,113451,474577,2.9,15.3,543517,202336,341181,5.3,14.1,44511,1.2,28.2,0,16748,16802,144260
2006,70,i) 16 to 20,201196,237078,4712754,4691460,8639,3.6,17857,7.4,545754,127383,418371,2.7,11.6,501596,160011,341585,3.4,10.7,44158,0.9,21.4,0,11231,11269,91591
2006,70,j) 21 to 25,180344,229213,4181303,4157064,8482,3.6,14553,6.3,485536,126882,358654,3.1,11.7,436462,127480,308982,3.1,10.5,49074,1.2,21,0,7895,7943,61640
2006,70,k) 26+,97087,153020,3364304,3343919,6428,4.2,9317,6,413139,128058,285081,3.8,12.4,372793,111061,261732,3.3,11.1,40346,1.3,22.2,0,4613,4645,41804
2006,70,l) Left Censored,229194,441928,17708067,17538864,25655,5.8,23493,5.3,2034256,554724,1479532,3.2,11.6,1681575,451312,1230263,2.6,9.6,352681,2,19.2,0,9115,9431,134739
2007,07,a) 0,13382,13383,55855,27928,12770,190.8,0,0,53778,53778,0,192.6,192.6,0,0,0,0,0,53778,192.6,0,0,,,
2007,07,b) 1,9926,9968,62144,64077,12,0.1,3644,30.5,19701,309,19392,0.5,30.7,22482,12516,9966,19.5,35.1,-2781,-4.4,61.4,0,2099,2099,6637
2007,07,c) 2,7973,7994,52465,54383,414,4.9,1486,17.5,10924,1310,9614,2.4,20.1,15217,5152,10065,9.5,28,-4293,-7.9,40.2,0,941,941,3590
2007,07,d) 3,6827,6857,44610,45289,426,5.9,1153,16,9899,2292,7607,5.1,21.9,11507,5029,6478,11.1,25.4,-1608,-3.5,43.8,0,729,729,3469
2007,07,e) 4,5790,5837,43724,43820,314,5.2,806,13.3,8865,1692,7173,3.9,20.2,9004,3527,5477,8,20.5,-139,-0.3,40.4,0,501,501,2040
2007,07,f) 5,5810,5820,46230,46883,285,4.7,772,12.8,8335,1224,7111,2.6,17.8,9727,3692,6035,7.9,20.7,-1392,-2.9,35.6,0,426,426,1926
2007,07,g) 6 to 10,22882,23308,209696,212457,1173,4.9,2707,11.3,37820,6030,31790,2.8,17.8,43775,15937,27838,7.5,20.6,-5955,-2.8,35.6,0,1481,1483,8711
2007,07,h) 11 to 15,15155,15775,161919,170870,688,4.3,1455,9,26077,5673,20404,3.3,15.3,44496,9907,34589,5.8,26,-18419,-10.7,30.6,0,785,785,6371
2007,07,i) 16 to 20,12845,12987,142246,145767,513,3.9,1129,8.5,19366,3080,16286,2.1,13.3,26316,7563,18753,5.2,18.1,-6950,-4.8,26.6,0,591,591,3873
2007,07,j) 21 to 25,7548,7680,97935,100231,236,3,578,7.4,10573,1401,9172,1.4,10.5,15245,3577,11668,3.6,15.2,-4672,-4.7,21,0,337,337,2112
2007,07,k) 26+,4998,5141,64758,65202,147,2.8,338,6.5,7236,1535,5701,2.4,11.1,8223,2172,6051,3.3,12.6,-987,-1.5,22.2,0,204,205,1248
2007,07,l) Left Censored,5221,7438,156301,157174,438,5.9,494,6.6,20976,5423,15553,3.5,13.3,22899,4833,18066,3.1,14.6,-1923,-1.3,26.6,0,254,256,1897
2007,10,a) 0,2106,2124,23425,11713,2089,196.7,0,0,23276,23276,0,198.7,198.7,0,0,0,0,0,23276,198.7,0,0,,,
2007,10,b) 1,1662,1727,28202,24616,24,1.3,330,17.4,13387,872,12515,3.5,54.4,6084,3831,2253,15.6,24.7,7303,29.7,49.4,0,246,246,3175
2007,10,c) 2,1115,1156,17737,16007,35,2.8,203,16.4,6976,945,6031,5.9,43.6,3531,2005,1526,12.5,22.1,3445,21.5,44.2,0,150,150,1767
2007,10,d) 3,878,896,15749,13708,33,3.6,89,9.6,6123,447,5676,3.3,44.7,1981,942,1039,6.9,14.5,4142,30.2,29,0,65,65,595
2007,10,e) 4,712,730,12100,11104,34,4.5,91,12.1,4233,213,4020,1.9,38.1,2274,1028,1246,9.3,20.5,1959,17.6,41,0,70,70,529
2007,10,f) 5,754,765,14925,14056,29,3.7,69,8.8,6555,737,5818,5.2,46.6,4772,3526,1246,25.1,33.9,1783,12.7,67.8,0,42,42,775
2007,10,g) 6 to 10,2864,3026,58457,50435,125,4,258,8.4,23399,5942,17457,11.8,46.4,7278,2913,4365,5.8,14.4,16121,32,28.8,0,179,182,2086
2007,10,h) 11 to 15,2086,2381,37506,35988,103,4.3,194,8,10045,1264,8781,3.5,27.9,7032,2790,4242,7.8,19.5,3013,8.4,39,0,109,109,1697
2007,10,i) 16 to 20,1778,1995,46540,41793,75,3.7,137,6.8,13847,948,12899,2.3,33.1,4267,1487,2780,3.6,10.2,9580,22.9,20.4,0,84,84,619
2007,10,j) 21 to 25,1747,1946,37551,34898,75,3.8,125,6.4,9844,1489,8355,4.3,28.2,4545,1937,2608,5.6,13,5299,15.2,26,0,80,80,1251
2007,10,k) 26+,1372,2006,53295,50698,110,5.5,143,7.1,11254,2149,9105,4.2,22.2,6054,2036,4018,4,11.9,5200,10.3,23.8,0,50,53,468
2007,10,l) Left Censored,2355,6066,344467,310268,526,8.7,489,8.1,104007,27039,76968,8.7,33.5,35607,13727,21880,4.4,11.5,68400,22,23,0,77,77,3863
2007,15,a) 0,35235,35242,145533,72767,34113,193.6,0,0,143042,143042,0,196.6,196.6,0,0,0,0,0,143042,196.6,0,0,,,
2007,15,b) 1,29296,29391,169716,179602,27,0.1,10236,29.3,48500,978,47522,0.5,27,66446,34069,32377,19,37,-17946,-10,54,0,7731,7731,26498
2007,15,c) 2,25086,25164,166750,176998,1074,4,5099,18.8,37861,4716,33145,2.7,21.4,58376,22040,36336,12.5,33,-20515,-11.6,42.8,0,3791,3791,17590
2007,15,d) 3,21386,21430,142326,148611,974,4.3,3944,17.3,31115,3586,27529,2.4,20.9,43804,15879,27925,10.7,29.5,-12689,-8.6,41.8,0,2886,2886,12217
2007,15,e) 4,17374,17575,136179,145518,804,4.2,3746,19.7,25825,3789,22036,2.6,17.7,44783,18086,26697,12.4,30.8,-18958,-13.1,35.4,0,2875,2875,13705
2007,15,f) 5,22832,22894,183447,194145,959,3.9,3970,16.3,32304,3429,28875,1.8,16.6,53694,18707,34987,9.6,27.7,-21390,-11.1,33.2,0,2969,2969,14862
2007,15,g) 6 to 10,112414,112973,979632,1020231,4321,3.7,13730,11.7,154421,15687,138734,1.5,15.1,238754,64750,174004,6.3,23.4,-84333,-8.3,30.2,0,9200,9222,47843
2007,15,h) 11 to 15,80430,80661,848118,875666,2525,3,8001,9.6,120635,11043,109592,1.3,13.8,176189,39336,136853,4.5,20.1,-55554,-6.3,27.6,0,5246,5247,28843
2007,15,i) 16 to 20,60954,61367,741374,767878,1871,3,5354,8.5,95251,8142,87109,1.1,12.4,147868,29092,118776,3.8,19.3,-52617,-6.9,24.8,0,3378,3382,18911
2007,15,j) 21 to 25,40109,40591,636546,650286,1065,2.6,3233,7.8,84287,4357,79930,0.7,13,111763,22631,89132,3.5,17.2,-27476,-4.2,26,0,2024,2024,11792
2007,15,k) 26+,29401,30202,524428,535331,819,2.6,2496,8,63701,5601,58100,1,11.9,86170,14583,71587,2.7,16.1,-22469,-4.2,23.8,0,1606,1611,8299
2007,15,l) Left Censored,38452,43149,1439298,1460310,764,1.7,3024,6.8,201455,13260,188195,0.9,13.8,243654,40180,203474,2.8,16.7,-42199,-2.9,27.6,0,1813,1819,12020
2007,20,a) 0,16556,16642,172309,86155,16294,195.8,0,0,170752,170752,0,198.2,198.2,0,0,0,0,0,170752,198.2,0,0,,,
2007,20,b) 1,14591,14871,173609,189781,85,0.5,3272,19.7,40925,2703,38222,1.4,21.6,71849,41966,29883,22.1,37.9,-30924,-16.3,43.2,0,2586,2586,36023
2007,20,c) 2,12515,12677,157218,164553,363,2.7,2061,15.3,29132,3778,25354,2.3,17.7,43266,23755,19511,14.4,26.3,-14134,-8.6,35.4,0,1694,1694,19578
2007,20,d) 3,11118,11326,160076,162512,361,3,1669,14,27971,4497,23474,2.8,17.2,32254,15607,16647,9.6,19.8,-4283,-2.6,34.4,0,1377,1377,12905
2007,20,e) 4,9787,9991,145911,147089,304,2.9,1193,11.5,24207,3705,20502,2.5,16.5,26991,12362,14629,8.4,18.4,-2784,-1.9,33,0,969,969,9852
2007,20,f) 5,9204,9336,157819,160090,254,2.6,1024,10.6,22414,3987,18427,2.5,14,27045,9655,17390,6,16.9,-4631,-2.9,28,0,804,806,7121
2007,20,g) 6 to 10,42147,43394,696522,707435,1256,2.8,4287,9.6,91851,16444,75407,2.3,13,113891,41883,72008,5.9,16.1,-22040,-3.1,26,0,3214,3220,30407
2007,20,h) 11 to 15,32683,33776,639918,652554,818,2.4,2752,7.9,70493,12222,58271,1.9,10.8,95534,29691,65843,4.5,14.6,-25041,-3.8,21.6,0,2025,2026,20360
2007,20,i) 16 to 20,28319,30988,881920,898159,797,2.5,2213,7,83202,15499,67703,1.7,9.3,115181,31673,83508,3.5,12.8,-31979,-3.5,18.6,0,1572,1579,19125
2007,20,j) 21 to 25,23319,26090,1028892,1032170,606,2.3,1664,6.3,110923,18284,92639,1.8,10.7,117925,32862,85063,3.2,11.4,-7002,-0.7,21.4,0,1140,1148,17542
2007,20,k) 26+,19574,23858,1117517,1131148,500,2.1,1431,5.9,99098,15877,83221,1.4,8.8,127520,37468,90052,3.3,11.3,-28422,-2.5,17.6,0,870,883,13486
2007,20,l) Left Censored,47371,89811,9411592,9544170,2082,2.3,4771,5.2,721974,120715,601259,1.3,7.6,987492,235387,752105,2.5,10.3,-265518,-2.7,15.2,0,1691,1740,36259
2007,40,a) 0,22825,22954,108344,54172,22359,194.8,0,0,106862,106862,0,197.3,197.3,0,0,0,0,0,106862,197.3,0,0,,,
2007,40,b) 1,17254,17834,113556,118688,156,0.7,5948,28.4,31628,2711,28917,2.3,26.6,40509,25645,14864,21.6,34.1,-8881,-7.5,53.2,0,4762,4765,21847
2007,40,c) 2,13972,14401,111847,114944,549,3.5,3163,20.2,22611,2939,19672,2.6,19.7,28747,14050,14697,12.2,25,-6136,-5.3,39.4,0,2553,2553,11542
2007,40,d) 3,11658,11928,93791,96750,465,3.7,2160,17,18100,3060,15040,3.2,18.7,23927,12641,11286,13.1,24.7,-5827,-6,37.4,0,1712,1727,9521
2007,40,e) 4,10066,10528,93480,94263,407,3.6,1731,15.5,19158,3502,15656,3.7,20.3,20486,9962,10524,10.6,21.7,-1328,-1.4,40.6,0,1374,1374,7482
2007,40,f) 5,8998,9845,90492,92925,458,4.4,1447,14,15634,2956,12678,3.2,16.8,20623,8913,11710,9.6,22.2,-4989,-5.4,33.6,0,1047,1066,5673
2007,40,g) 6 to 10,37215,41465,485686,485918,1921,4.5,4911,11.5,83103,16615,66488,3.4,17.1,84035,31463,52572,6.5,17.3,-932,-0.2,34.2,0,3411,3476,19528
2007,40,h) 11 to 15,23849,25934,333825,337213,970,3.6,2703,10.1,47570,10981,36589,3.3,14.1,54719,19979,34740,5.9,16.2,-7149,-2.1,28.2,0,1864,1872,12610
2007,40,i) 16 to 20,16780,22043,417344,414518,1400,6.3,1860,8.4,70284,18748,51536,4.5,17,64523,18549,45974,4.5,15.6,5761,1.4,31.2,0,1020,1041,8482
2007,40,j) 21 to 25,10781,31421,813435,807651,3665,11.8,2938,9.5,151748,62467,89281,7.7,18.8,140427,39049,101378,4.8,17.4,11321,1.4,34.8,0,579,599,5200
2007,40,k) 26+,7959,18929,596449,591758,1657,8.7,1726,9.1,79008,20841,58167,3.5,13.4,69836,24660,45176,4.2,11.8,9172,1.6,23.6,0,420,430,3989
2007,40,l) Left Censored,15747,80012,3531750,3496586,8152,10.2,7541,9.5,517061,199520,317541,5.7,14.8,450001,169291,280710,4.8,12.9,67060,1.9,25.8,0,591,618,7656
2007,50,a) 0,23476,23754,108657,54329,23200,195.3,0,0,107178,107178,0,197.3,197.3,0,0,0,0,0,107178,197.3,0,0,,,
2007,50,b) 1,20210,21015,126587,129461,301,1.3,5092,21.5,34488,3280,31208,2.5,26.6,39092,24739,14353,19.1,30.2,-4604,-3.6,53.2,0,3849,3849,19973
2007,50,c) 2,18060,18526,110705,112264,647,3.3,3103,15.7,24839,4149,20690,3.7,22.1,28279,13923,14356,12.4,25.2,-3440,-3.1,44.2,0,2472,2472,10440
2007,50,d) 3,15664,16258,112428,112727,583,3.4,2444,14.2,23236,3679,19557,3.3,20.6,23728,11892,11836,10.5,21,-492,-0.4,41.2,0,1889,1889,8330
2007,50,e) 4,14436,15138,107944,106317,524,3.3,2027,12.8,22991,4269,18722,4,21.6,19775,9435,10340,8.9,18.6,3216,3,37.2,0,1565,1565,7182
2007,50,f) 5,14173,16068,157738,159372,569,3.4,1824,10.9,25175,3740,21435,2.3,15.8,28266,10821,17445,6.8,17.7,-3091,-1.9,31.6,0,1328,1330,7339
2007,50,g) 6 to 10,54371,57390,525657,535482,1904,3.2,6505,10.9,77073,14639,62434,2.7,14.4,96878,40825,56053,7.6,18.1,-19805,-3.7,28.8,0,4264,4350,25511
2007,50,h) 11 to 15,44915,47044,475578,484044,1394,2.9,4138,8.6,60698,11940,48758,2.5,12.5,78205,30541,47664,6.3,16.2,-17507,-3.7,25,0,2771,2795,16347
2007,50,i) 16 to 20,36075,41794,613937,612300,1210,2.8,3188,7.5,85465,17452,68013,2.9,14,82030,28163,53867,4.6,13.4,3435,0.6,26.8,0,1936,1969,14496
2007,50,j) 21 to 25,28296,36286,585812,587485,1289,3.5,2731,7.4,78806,16838,61968,2.9,13.4,81494,28841,52653,4.9,13.9,-2688,-0.5,26.8,0,1368,1398,10162
2007,50,k) 26+,22538,34969,655064,661262,1805,5.1,2471,7,88927,29374,59553,4.4,13.4,101304,29648,71656,4.5,15.3,-12377,-1.9,26.8,0,991,1064,8857
2007,50,l) Left Censored,47133,133733,3379599,3419309,7571,5.6,8700,6.5,428066,121065,307001,3.5,12.5,507352,154318,353034,4.5,14.8,-79286,-2.3,25,0,1810,2031,21821
2007,52,a) 0,111892,113130,883374,441687,110500,195.4,0,0,871914,871914,0,197.4,197.4,0,0,0,0,0,871914,197.4,0,0,,,
2007,52,b) 1,88937,92446,826227,900616,918,0.9,26351,24.8,168535,12230,156305,1.4,18.7,309638,158944,150694,17.6,34.4,-141103,-15.7,37.4,0,22078,22091,135435
2007,52,c) 2,74443,77414,710924,763922,2938,3.5,16496,19.6,119411,22426,96985,2.9,15.6,225351,113184,112167,14.8,29.5,-105940,-13.9,31.2,0,13995,14004,96735
2007,52,d) 3,60973,64109,599465,625487,2532,3.7,12136,17.7,100878,20861,80017,3.3,16.1,155561,81305,74256,13,24.9,-54683,-8.8,32.2,0,10197,10231,65937
2007,52,e) 4,50927,55755,541808,557703,2439,4.1,9159,15.6,93838,20708,73130,3.7,16.8,126443,62057,64386,11.1,22.7,-32605,-5.9,33.6,0,7466,7495,48524
2007,52,f) 5,46466,48699,494200,516096,1855,3.6,7614,14.8,70109,15461,54648,3,13.6,114905,53475,61430,10.4,22.3,-44796,-8.7,27.2,0,5945,5984,38608
2007,52,g) 6 to 10,171786,191918,2148565,2210783,7392,3.7,24345,12.2,307476,74835,232641,3.4,13.9,433983,180560,253423,8.2,19.6,-126507,-5.7,27.8,0,17693,17960,124373
2007,52,h) 11 to 15,111323,128408,1625488,1670341,4680,3.5,13678,10.3,206156,55828,150328,3.3,12.3,296672,108992,187680,6.5,17.8,-90516,-5.5,24.6,0,9518,9813,70101
2007,52,i) 16 to 20,81043,116817,1747331,1759728,5348,4.5,9784,8.2,241103,68108,172995,3.9,13.7,264901,80790,184111,4.6,15.1,-23798,-1.4,27.4,0,6067,6246,46485
2007,52,j) 21 to 25,58454,95495,1659405,1669469,6326,6.6,7317,7.6,221077,82251,138826,4.9,13.2,241219,67151,174068,4,14.4,-20142,-1.2,26.4,0,3940,4232,33159
2007,52,k) 26+,46469,102395,2294915,2282825,6241,6.1,6998,6.8,328213,116884,211329,5.1,14.4,307395,67275,240120,2.9,13.5,20818,0.9,27,0,2748,3015,24233
2007,52,l) Left Censored,75684,422392,12073845,12082267,30883,7.4,21887,5.2,1511923,542096,969827,4.5,12.5,1526685,299253,1227432,2.5,12.6,-14762,-0.1,25,0,4179,4728,42571
2007,60,a) 0,51692,52402,199371,99686,51063,194.9,0,0,195990,195990,0,196.6,196.6,0,0,0,0,0,195990,196.6,0,0,,,
2007,60,b) 1,42099,44769,200094,215656,518,1,14083,27,50237,3971,46266,1.8,23.3,79053,45280,33773,21,36.7,-28816,-13.4,46.6,0,10521,10586,35810
2007,60,c) 2,34499,37242,174521,180620,1684,4.2,7342,18.3,37133,5942,31191,3.3,20.6,49036,23548,25488,13,27.1,-11903,-6.5,41.2,0,5608,5608,18001
2007,60,d) 3,28882,29688,150462,155673,1143,3.6,5048,16,28070,4756,23314,3.1,18,38781,17936,20845,11.5,24.9,-10711,-6.9,36,0,3842,3842,14048
2007,60,e) 4,24875,26765,148185,153384,1157,4.1,3831,13.7,29436,6002,23434,3.9,19.2,40020,21170,18850,13.8,26.1,-10584,-6.9,38.4,0,2782,2782,14685
2007,60,f) 5,22028,23764,168964,170112,1118,4.5,3239,13.1,34220,9532,24688,5.6,20.1,36686,16407,20279,9.6,21.6,-2466,-1.5,40.2,0,2213,2230,10140
2007,60,g) 6 to 10,84680,97989,722050,742310,5118,5.1,10831,10.8,120903,32024,88879,4.3,16.3,162186,64042,98144,8.6,21.8,-41283,-5.5,32.6,0,6988,7121,37787
2007,60,h) 11 to 15,53045,60017,474257,484935,2755,4.5,5414,8.8,68014,21452,46562,4.4,14,89079,32918,56161,6.8,18.4,-21065,-4.4,28,0,3491,3534,17832
2007,60,i) 16 to 20,40775,53693,507329,506472,3109,5.7,4537,8.3,78313,26349,51964,5.2,15.5,76298,23970,52328,4.7,15.1,2015,0.4,30.2,0,2330,2392,11364
2007,60,j) 21 to 25,31314,45617,456143,467976,2882,6.3,3507,7.6,70959,23154,47805,4.9,15.2,94516,35785,58731,7.6,20.2,-23557,-5,30.4,0,1562,1582,8986
2007,60,k) 26+,24160,42875,489308,491339,3008,7,2750,6.4,76413,27276,49137,5.6,15.6,81499,19491,62008,4,16.6,-5086,-1,31.2,0,1255,1304,6174
2007,60,l) Left Censored,50876,249289,4989243,4988852,29039,11.8,21068,8.6,837146,341218,495928,6.8,16.8,841886,312723,529163,6.3,16.9,-4740,-0.1,33.6,0,1938,2153,18195
2007,70,a) 0,239383,240543,1312751,656376,234208,194.7,0,0,1293819,1293819,0,197.1,197.1,0,0,0,0,0,1293819,197.1,0,0,,,
2007,70,b) 1,193138,198506,1496475,1506658,981,0.4,52027,23,406618,20699,385919,1.4,27,412290,215398,196892,14.3,27.4,-5672,-0.4,54,0,38736,38804,171224
2007,70,c) 2,164065,167260,1424026,1451226,6373,3.6,28864,16.2,310129,43450,266679,3,21.4,364686,165018,199668,11.4,25.1,-54557,-3.7,42.8,0,22145,22252,130494
2007,70,d) 3,141342,143801,1242306,1266501,5281,3.5,21249,14,239776,34296,205480,2.7,18.9,289233,132359,156874,10.5,22.8,-49457,-3.9,37.8,0,16231,16239,106669
2007,70,e) 4,123750,128970,1306600,1303335,5086,3.8,15382,11.5,270688,45912,224776,3.5,20.8,267290,101548,165742,7.8,20.5,3398,0.3,41,0,11257,11265,70060
2007,70,f) 5,103355,106029,1162245,1177741,3575,3.3,11945,10.9,183383,25430,157953,2.2,15.6,215990,85157,130833,7.2,18.3,-32607,-2.7,31.2,0,8544,8589,58563
2007,70,g) 6 to 10,395833,425689,5377819,5445163,16490,3.8,43924,10,806459,155662,650797,2.9,14.8,951478,361844,589634,6.6,17.5,-145019,-2.7,29.6,0,28683,29050,221490
2007,70,h) 11 to 15,261522,286765,3921545,3973722,11256,3.8,24030,8.2,544857,114801,430056,2.9,13.7,650153,206571,443582,5.2,16.4,-105296,-2.7,27.4,0,15856,15957,115021
2007,70,i) 16 to 20,199286,234124,4530863,4527892,10014,4.2,17675,7.4,602446,117117,485329,2.6,13.3,603386,176128,427258,3.9,13.3,-940,0,26.6,0,10293,10439,75393
2007,70,j) 21 to 25,183201,230442,4199377,4213977,8463,3.6,16332,7,523813,125837,397976,3,12.4,553478,159128,394350,3.8,13.1,-29665,-0.7,24.8,0,7407,7595,50056
2007,70,k) 26+,121542,190256,4351993,4311587,9652,5,12227,6.4,586166,140079,446087,3.2,13.6,506012,127576,378436,3,11.7,80154,1.9,23.4,0,5415,5628,35103
2007,70,l) Left Censored,222304,435669,17857483,17778083,26359,6,30555,7,2182046,542478,1639568,3.1,12.3,2036524,593106,1443418,3.3,11.5,145522,0.8,23,0,7878,8358,83386
2008,07,a) 0,12873,12884,60242,30121,12349,191.7,0,0,58745,58745,0,195,195,0,0,0,0,0,58745,195,0,0,,,
2008,07,b) 1,9285,9286,49503,52529,0,0,3813,33.6,14494,0,14494,0,27.6,19890,12678,7212,24.1,37.9,-5396,-10.3,55.2,0,2249,2249,7999
2008,07,c) 2,8598,8644,61720,61935,549,5.9,1936,20.8,21689,11818,9871,19.1,35,22565,14376,8189,23.2,36.4,-876,-1.4,70,0,1122,1122,4250
2008,07,d) 3,7157,7180,48596,50517,373,4.9,1214,16,8423,1789,6634,3.5,16.7,12057,4364,7693,8.6,23.9,-3634,-7.2,33.4,0,805,805,2868
2008,07,e) 4,6186,6216,43728,44227,353,5.4,1025,15.7,9161,1900,7261,4.3,20.7,10211,3714,6497,8.4,23.1,-1050,-2.4,41.4,0,625,625,2517
2008,07,f) 5,5330,5388,41366,42497,268,4.8,745,13.3,7091,1240,5851,2.9,16.7,9498,3539,5959,8.3,22.3,-2407,-5.6,33.4,0,474,474,2409
2008,07,g) 6 to 10,23366,23743,218083,220732,1106,4.5,2783,11.3,40486,4500,35986,2,18.3,45873,17322,28551,7.8,20.8,-5387,-2.5,36.6,0,1595,1595,9353
2008,07,h) 11 to 15,15418,16228,161247,164080,856,5.2,1540,9.3,23159,6566,16593,4,14.1,28830,9053,19777,5.5,17.6,-5671,-3.5,28.2,0,843,843,4790
2008,07,i) 16 to 20,12785,12909,140891,144051,493,3.7,1214,9.2,18319,2884,15435,2,12.7,24740,7310,17430,5.1,17.2,-6421,-4.5,25.4,0,659,659,4432
2008,07,j) 21 to 25,8108,8229,97440,98928,251,3,587,7,10587,1418,9169,1.4,10.7,13571,3207,10364,3.2,13.7,-2984,-3,21.4,0,325,325,2053
2008,07,k) 26+,5883,6070,85391,85351,149,2.4,428,6.9,9824,967,8857,1.1,11.5,9658,2496,7162,2.9,11.3,166,0.2,22.6,0,269,271,1808
2008,07,l) Left Censored,4990,7135,146940,150126,215,3,394,5.5,13976,3051,10925,2,9.3,20336,3014,17322,2,13.5,-6360,-4.2,18.6,0,225,225,1779
2008,10,a) 0,1950,1967,16395,8198,1936,196.8,0,0,16281,16281,0,198.6,198.6,0,0,0,0,0,16281,198.6,0,0,,,
2008,10,b) 1,1684,1696,20100,21275,6,0.3,402,21.1,5884,244,5640,1.1,27.7,8154,3614,4540,17,38.3,-2270,-10.6,55.4,0,308,308,3116
2008,10,c) 2,1452,1510,24544,26105,36,2.2,240,14.9,5444,974,4470,3.7,20.9,8608,2147,6461,8.2,33,-3164,-12.1,41.8,0,200,200,2023
2008,10,d) 3,1004,1045,15122,16346,39,3.5,150,13.6,3120,442,2678,2.7,19.1,5506,1774,3732,10.9,33.7,-2386,-14.6,38.2,0,123,123,1537
2008,10,e) 4,807,831,14240,14901,28,3.2,93,10.8,2007,145,1862,1,13.5,3530,1322,2208,8.9,23.7,-1523,-10.2,27,0,78,78,1266
2008,10,f) 5,632,650,10594,11236,16,2.3,96,13.9,1264,134,1130,1.2,11.2,2637,652,1985,5.8,23.5,-1373,-12.3,22.4,0,74,74,516
2008,10,g) 6 to 10,2871,3000,43602,49488,81,2.6,303,9.7,6497,703,5794,1.4,13.1,18150,6771,11379,13.7,36.7,-11653,-23.6,26.2,0,211,211,2458
2008,10,h) 11 to 15,2131,2448,41055,44728,65,2.6,173,6.9,5578,932,4646,2.1,12.5,13261,2321,10940,5.2,29.6,-7683,-17.1,25,0,115,115,1462
2008,10,i) 16 to 20,1740,1977,39896,42076,134,6.8,148,7.5,5911,2238,3673,5.3,14,10267,1903,8364,4.5,24.4,-4356,-10.4,28,0,97,97,1123
2008,10,j) 21 to 25,1585,1833,31947,33322,84,4.6,94,5.1,4796,1542,3254,4.6,14.4,7533,651,6882,2,22.6,-2737,-8.2,28.8,0,69,69,503
2008,10,k) 26+,1698,2533,62928,63710,214,8.6,154,6.2,12768,5604,7164,8.8,20,14298,2233,12065,3.5,22.4,-1530,-2.4,40,0,93,93,935
2008,10,l) Left Censored,2274,6095,306533,325603,354,5.8,271,4.5,45711,11293,34418,3.5,14,83701,7575,76126,2.3,25.7,-37990,-11.7,28,0,73,74,946
2008,15,a) 0,28729,28783,120545,60273,27771,193,0,0,117181,,,,194.4,0,0,0,0,0,117181,194.4,0,1,,,
2008,15,b) 1,23848,23859,124964,135271,5,0,10765,36.4,35606,,,,26.3,54767,31173,23594,23,40.5,-19161,-14.2,52.6,1,8129,8129,24855
2008,15,c) 2,23524,23616,141003,155055,962,3.6,6793,25.6,31781,3763,28018,2.4,20.5,60312,26630,33682,17.2,38.9,-28531,-18.4,41,0,5103,5103,21001
2008,15,d) 3,20961,21058,143900,155360,810,3.5,5041,21.8,27862,2979,24883,1.9,17.9,50918,19815,31103,12.8,32.8,-23056,-14.9,35.8,0,3740,3740,15922
2008,15,e) 4,18255,18299,125193,133869,712,3.6,3937,19.8,22343,2140,20203,1.6,16.7,39739,14477,25262,10.8,29.7,-17396,-13,33.4,0,2853,2853,11290
2008,15,f) 5,15426,15627,120511,128516,631,3.8,2779,16.7,20175,2504,17671,1.9,15.7,36790,11049,25741,8.6,28.6,-16615,-12.9,31.4,0,1957,1957,8594
2008,15,g) 6 to 10,104113,104669,878100,921961,3742,3.4,15117,13.7,138049,17546,120503,1.9,15,227008,61480,165528,6.7,24.6,-88959,-9.6,30,0,10206,10210,46375
2008,15,h) 11 to 15,81103,81267,815504,852103,2557,3,9357,11.1,111716,8980,102736,1.1,13.1,184427,39788,144639,4.7,21.6,-72711,-8.5,26.2,0,6052,6052,29957
2008,15,i) 16 to 20,58152,58578,694055,720828,1620,2.7,5958,9.8,88084,7307,80777,1,12.2,142436,28646,113790,4,19.8,-54352,-7.6,24.4,0,3693,3693,19964
2008,15,j) 21 to 25,43289,43768,640589,660927,1161,2.6,3917,8.7,77275,5813,71462,0.9,11.7,118653,18042,100611,2.7,18,-41378,-6.3,23.4,0,2479,2480,13200
2008,15,k) 26+,32689,33542,591746,605331,761,2.2,2969,8.6,73756,5748,68008,0.9,12.2,101461,18302,83159,3,16.8,-27705,-4.6,24.4,0,1923,1924,11464
2008,15,l) Left Censored,36485,41256,1420108,1432037,838,2,2667,6.3,201703,19200,182503,1.3,14.1,226654,26091,200563,1.8,15.8,-24951,-1.7,28.2,0,1758,1758,9674
2008,20,a) 0,14329,14411,154042,77021,14103,195.7,0,0,152239,152239,0,197.7,197.7,0,0,0,0,0,152239,197.7,0,0,,,
2008,20,b) 1,12861,12947,132624,150290,22,0.1,3451,23.4,30995,678,30317,0.5,20.6,65654,38871,26783,25.9,43.7,-34659,-23.1,41.2,0,2771,2771,34755
2008,20,c) 2,12618,12893,164293,167500,317,2.3,2306,16.6,30555,3877,26678,2.3,18.2,37052,18483,18569,11,22.1,-6497,-3.9,36.4,0,1857,1857,16060
2008,20,d) 3,11056,11217,147049,150723,259,2.2,1734,14.5,21950,2765,19185,1.8,14.6,29885,14122,15763,9.4,19.8,-7935,-5.2,29.2,0,1440,1440,11495
2008,20,e) 4,9936,10175,151313,153346,285,2.7,1451,13.5,23089,2496,20593,1.6,15.1,28143,12690,15453,8.3,18.4,-5054,-3.3,30.2,0,1201,1201,10833
2008,20,f) 5,8810,9013,133800,136691,204,2.2,1175,12.4,18205,3360,14845,2.5,13.3,24164,10488,13676,7.7,17.7,-5959,-4.4,26.6,0,956,956,9044
2008,20,g) 6 to 10,40313,41404,680976,692393,1017,2.4,4316,10,84234,15137,69097,2.2,12.2,108174,40905,67269,5.9,15.6,-23940,-3.4,24.4,0,3386,3389,32714
2008,20,h) 11 to 15,32658,33834,651524,660253,757,2.2,2906,8.3,69718,11914,57804,1.8,10.6,88803,28536,60267,4.3,13.4,-19085,-2.8,21.2,0,2254,2255,22123
2008,20,i) 16 to 20,27201,29471,797602,803398,878,2.9,2286,7.6,77925,12460,65465,1.6,9.7,90059,24963,65096,3.1,11.2,-12134,-1.5,19.4,0,1550,1553,16452
2008,20,j) 21 to 25,23383,26091,967782,979825,520,2,1558,5.9,88358,18045,70313,1.8,9,112373,24079,88294,2.5,11.5,-24015,-2.5,18,0,1135,1136,13434
2008,20,k) 26+,22657,27597,1289191,1303459,527,1.9,1486,5.3,105579,20892,84687,1.6,8.1,134742,29925,104817,2.3,10.3,-29163,-2.2,16.2,0,1069,1073,15151
2008,20,l) Left Censored,45438,87064,9101633,9234176,1885,2.1,3551,4,645732,106345,539387,1.2,7,912162,175045,737117,1.9,9.9,-266430,-2.9,14,0,1658,1696,38996
2008,40,a) 0,20722,20964,94081,47041,20405,194.7,0,0,92718,92718,0,197.1,197.1,0,0,0,0,0,92718,197.1,0,0,,,
2008,40,b) 1,16075,16242,90951,97800,39,0.2,6326,32.3,22677,465,22212,0.5,23.2,35237,23378,11859,23.9,36,-12560,-12.8,46.4,0,5040,5040,20147
2008,40,c) 2,14140,14760,108186,111620,480,2.9,3622,22.2,21373,1706,19667,1.5,19.1,28556,14676,13880,13.1,25.6,-7183,-6.5,38.2,0,2816,2816,11955
2008,40,d) 3,11906,12298,103956,107430,413,3.1,2537,19,17613,1507,16106,1.4,16.4,24650,12729,11921,11.8,22.9,-7037,-6.5,32.8,0,2055,2055,10730
2008,40,e) 4,10095,10381,89007,91171,290,2.6,1895,17,14856,1782,13074,2,16.3,19787,9542,10245,10.5,21.7,-4931,-5.4,32.6,0,1554,1554,6934
2008,40,f) 5,8880,9335,88336,90663,269,2.7,1488,15,13215,1307,11908,1.4,14.6,18367,8651,9716,9.5,20.3,-5152,-5.7,29.2,0,1178,1178,7704
2008,40,g) 6 to 10,36118,40781,469719,482676,1292,3,5109,12,60513,8598,51915,1.8,12.5,87118,31512,55606,6.5,18,-26605,-5.5,25,0,3779,3804,23157
2008,40,h) 11 to 15,24236,25790,323778,330142,764,2.9,2815,10.5,39571,7378,32193,2.2,12,52802,19427,33375,5.9,16,-13231,-4,24,0,1980,1980,14293
2008,40,i) 16 to 20,16330,19672,347039,348111,657,3.2,1775,8.8,43496,8754,34742,2.5,12.5,45694,13846,31848,4,13.1,-2198,-0.6,25,0,1129,1129,7486
2008,40,j) 21 to 25,11411,21893,595061,595374,1107,5,1584,7.2,76514,14908,61606,2.5,12.9,77325,30974,46351,5.2,13,-811,-0.1,25.8,0,692,694,6959
2008,40,k) 26+,9218,31319,921047,915699,2125,6.8,2346,7.5,126766,33141,93625,3.6,13.8,116236,20697,95539,2.3,12.7,10530,1.1,25.4,0,468,492,4147
2008,40,l) Left Censored,15142,81422,3551174,3547161,8011,10,5931,7.4,396911,126217,270694,3.6,11.2,389087,80807,308280,2.3,11,7824,0.2,22,0,523,525,8148
2008,50,a) 0,21735,21883,106086,53043,21382,195.4,0,0,105135,105135,0,198.2,198.2,0,0,0,0,0,105135,198.2,0,0,,,
2008,50,b) 1,17987,18283,93944,100811,34,0.2,5117,24.4,23530,475,23055,0.5,23.3,36399,24127,12272,23.9,36.1,-12869,-12.8,46.6,0,3935,3935,20574
2008,50,c) 2,17409,18288,114960,120225,590,3,3354,17.1,20871,2296,18575,1.9,17.4,31511,14371,17140,12,26.2,-10640,-8.8,34.8,0,2638,2639,12490
2008,50,d) 3,15948,16397,106420,108009,438,2.5,2574,14.8,18276,1688,16588,1.6,16.9,21558,10967,10591,10.2,20,-3282,-3.1,33.8,0,2144,2144,9262
2008,50,e) 4,14035,14627,108494,109932,384,2.5,2057,13.3,17641,2619,15022,2.4,16,20712,8785,11927,8,18.8,-3071,-2.8,32,0,1664,1664,7132
2008,50,f) 5,13068,13846,102444,104567,394,2.7,1731,12,14765,1887,12878,1.8,14.1,19231,8482,10749,8.1,18.4,-4466,-4.3,28.2,0,1413,1413,7455
2008,50,g) 6 to 10,53924,58309,568594,573456,1430,2.4,5820,9.6,76727,11776,64951,2.1,13.4,87912,33490,54422,5.8,15.3,-11185,-1.9,26.8,0,4412,4417,27082
2008,50,h) 11 to 15,44468,46518,470364,476948,1113,2.3,3970,8.3,53390,7452,45938,1.6,11.2,67119,22726,44393,4.8,14.1,-13729,-2.9,22.4,0,2910,2910,17729
2008,50,i) 16 to 20,35210,40141,574999,578939,902,2.2,2788,6.8,57196,9515,47681,1.6,9.9,65504,19349,46155,3.3,11.3,-8308,-1.4,19.8,0,1978,1979,13235
2008,50,j) 21 to 25,28458,36005,566514,571652,829,2.3,2121,5.8,60266,12184,48082,2.1,10.5,71242,22771,48471,4,12.5,-10976,-2,21,0,1420,1422,13613
2008,50,k) 26+,26198,41223,787958,789905,1550,3.7,1994,4.8,87758,18035,69723,2.3,11.1,91862,23887,67975,3,11.6,-4104,-0.5,22.2,0,1195,1197,11717
2008,50,l) Left Censored,44821,130350,3307845,3321678,5999,4.6,6427,4.9,399884,113130,286754,3.4,12,433471,110954,322517,3.3,13,-33587,-1,24,0,1716,1790,24635
2008,52,a) 0,107250,108989,878575,439288,106331,195.1,0,0,856299,856299,0,194.9,194.9,0,0,0,0,0,856299,194.9,0,0,,,
2008,52,b) 1,83365,84818,727030,801717,247,0.2,26826,27.1,146876,4252,142624,0.5,18.3,289336,156555,132781,19.5,36.1,-142460,-17.8,36.6,0,22601,22601,138289
2008,52,c) 2,74152,78086,710981,765668,2456,2.9,17107,20.1,104620,18153,86467,2.4,13.7,215427,109270,106157,14.3,28.1,-110807,-14.4,27.4,0,14615,14615,96671
2008,52,d) 3,63557,66612,630202,667196,1904,2.6,13044,18.1,87926,13914,74012,2.1,13.2,161946,82239,79707,12.3,24.3,-74020,-11.1,26.4,0,11233,11244,72362
2008,52,e) 4,52806,56226,542695,569382,1739,2.9,9839,16.4,74431,12885,61546,2.3,13.1,128126,63307,64819,11.1,22.5,-53695,-9.4,26.2,0,8422,8427,54936
2008,52,f) 5,44636,49873,502762,520940,1601,3,7734,14.6,71586,13769,57817,2.6,13.7,109276,51212,58064,9.8,21,-37690,-7.3,27.4,0,6572,6572,44934
2008,52,g) 6 to 10,171302,189953,2126937,2193431,5299,2.7,23387,11.8,265547,47942,217605,2.2,12.1,403004,168444,234560,7.7,18.4,-137457,-6.3,24.2,0,18881,18955,138695
2008,52,h) 11 to 15,112613,128529,1646629,1672545,3528,2.7,12427,9.4,201338,45424,155914,2.7,12,252449,90195,162254,5.4,15.1,-51111,-3.1,24,0,9773,9843,74092
2008,52,i) 16 to 20,78914,109531,1666576,1659786,3645,3.3,8198,7.3,236797,52895,183902,3.2,14.3,224457,68969,155488,4.2,13.5,12340,0.8,27,0,5845,5868,47224
2008,52,j) 21 to 25,59352,100606,1757767,1763287,3224,3.2,5705,5.6,203804,53667,150137,3,11.6,215573,51091,164482,2.9,12.2,-11769,-0.6,23.2,0,4113,4142,34272
2008,52,k) 26+,52820,112931,2456001,2473101,3768,3.3,5298,4.7,279321,74068,205253,3,11.3,313801,54876,258925,2.2,12.7,-34480,-1.4,22.6,0,3219,3249,28399
2008,52,l) Left Censored,71222,419823,12135992,12049462,17904,4.3,11735,2.8,1304622,398204,906418,3.3,10.8,1136422,179324,957098,1.5,9.4,168200,1.4,18.8,0,3755,3783,37895
2008,60,a) 0,41599,42585,179537,89769,41362,194.3,0,0,176915,176915,0,197.1,197.1,0,0,0,0,0,176915,197.1,0,0,,,
2008,60,b) 1,35405,36215,150271,172565,142,0.3,15307,34.6,33850,1225,32625,0.7,19.6,76653,48065,28588,27.9,44.4,-42803,-24.8,39.2,0,11909,11909,40801
2008,60,c) 2,33049,35714,164898,181064,1308,3.3,10128,25.3,27568,4024,23544,2.2,15.2,59897,33181,26716,18.3,33.1,-32329,-17.9,30.4,0,7847,7847,28274
2008,60,d) 3,28466,31326,149190,160924,1137,3.3,6981,20.4,25408,6442,18966,4,15.8,49065,22063,27002,13.7,30.5,-23657,-14.7,31.6,0,5494,5494,18740
2008,60,e) 4,24541,25437,125419,136578,814,3,5077,18.4,19335,2698,16637,2,14.2,41873,21599,20274,15.8,30.7,-22538,-16.5,28.4,0,3948,3959,18723
2008,60,f) 5,21631,23808,134591,141649,1024,4.1,3983,15.8,21617,5853,15764,4.1,15.3,35972,16096,19876,11.4,25.4,-14355,-10.1,30.6,0,3034,3038,13695
2008,60,g) 6 to 10,83568,95645,689555,720548,2851,2.8,11937,11.9,91700,17616,74084,2.4,12.7,154547,63758,90789,8.8,21.4,-62847,-8.7,25.4,0,8816,8850,50852
2008,60,h) 11 to 15,53952,60646,489418,505640,1885,3,6207,9.9,58004,13984,44020,2.8,11.5,90943,32387,58556,6.4,18,-32939,-6.5,23,0,4205,4205,20849
2008,60,i) 16 to 20,38956,50915,462065,470192,1759,3.4,3653,7,56552,14993,41559,3.2,12,73237,22458,50779,4.8,15.6,-16685,-3.6,24,0,2457,2459,14692
2008,60,j) 21 to 25,32463,48065,457145,462706,2687,5.5,3521,7.3,61798,21668,40130,4.7,13.4,73145,26610,46535,5.8,15.8,-11347,-2.4,26.8,0,1824,1859,10252
2008,60,k) 26+,27922,50370,585597,585526,2938,5.8,2723,5.4,76571,28116,48455,4.8,13.1,76649,24151,52498,4.1,13.1,-78,0,26.2,0,1432,1460,8334
2008,60,l) Left Censored,48909,249371,4939281,4924173,22213,9,17131,6.9,712931,271721,441210,5.5,14.5,684232,195094,489138,4,13.9,28699,0.6,27.8,0,1821,1847,20568
2008,70,a) 0,223339,224750,1174246,587123,218823,194.7,0,0,1155706,,,,196.8,0,0,0,0,0,1155706,196.8,0,1,,,
2008,70,b) 1,180446,181781,1290924,1300034,246,0.1,54609,25.9,357786,,,,27.5,364428,210254,154174,16.2,28,-6642,-0.5,55,1,40907,40907,175787
2008,70,c) 2,166358,171855,1389994,1432660,5625,3,32711,17.7,261065,26481,234584,1.8,18.2,349031,170191,178840,11.9,24.4,-87966,-6.2,36.4,0,24456,24472,141931
2008,70,d) 3,144824,148201,1357537,1383188,4758,3,24239,15.4,255741,46071,209670,3.3,18.5,309856,142701,167155,10.3,22.4,-54115,-3.9,37,0,18704,18711,123965
2008,70,e) 4,126555,129236,1200287,1218404,3931,2.9,19111,14,197912,19302,178610,1.6,16.2,236967,107230,129737,8.8,19.4,-39055,-3.2,32.4,0,14633,14640,92005
2008,70,f) 5,112188,117664,1238215,1270315,3623,2.9,15109,12.3,189844,23838,166006,1.9,14.9,255426,110719,144707,8.7,20.1,-65582,-5.2,29.8,0,11446,11450,96003
2008,70,g) 6 to 10,401896,431123,5546737,5592423,13101,2.9,43062,9.7,761131,117558,643573,2.1,13.6,859919,322360,537559,5.8,15.4,-98788,-1.8,27.2,0,31324,31357,245042
2008,70,h) 11 to 15,268674,289765,3919859,3944742,8810,3,24002,8.1,531031,132325,398706,3.4,13.5,585119,182625,402494,4.6,14.8,-54088,-1.3,27,0,16600,16605,122430
2008,70,i) 16 to 20,195771,227266,3794795,3837609,7119,3.1,16932,7.3,470076,93347,376729,2.4,12.2,552794,176420,376374,4.6,14.4,-82718,-2.2,24.4,0,10513,10524,77083
2008,70,j) 21 to 25,185042,230571,4826335,4802532,6631,2.8,12800,5.5,515465,129321,386144,2.7,10.7,469163,116062,353101,2.4,9.8,46302,0.9,19.6,0,8000,8079,60629
2008,70,k) 26+,142590,220413,5280672,5241923,7889,3.5,12204,5.5,661760,159356,502404,3,12.6,586058,153136,432922,2.9,11.2,75702,1.4,22.4,0,6459,6487,44291
2008,70,l) Left Censored,214293,434011,17943118,17837721,21046,4.9,20068,4.6,1977754,576977,1400777,3.2,11.1,1775982,408935,1367047,2.3,10,201772,1.1,20,0,7412,7499,84356
2009,07,a) 0,10054,10064,44763,22382,9689,192.5,0,0,43957,43957,0,196.4,196.4,0,0,0,0,0,43957,196.4,0,0,,,
2009,07,b) 1,8900,8917,47630,54001,5,0,3976,36.5,11944,,,,22.1,24685,11880,12805,22,45.7,-12741,-23.6,44.2,1,2118,2118,6695
2009,07,c) 2,7716,7717,56037,52786,446,5.2,2174,25.6,24020,,,,45.5,17833,10342,7491,19.6,33.8,6187,11.7,67.6,1,1224,1224,6544
2009,07,d) 3,7495,7536,46316,53853,402,5,1620,20,8871,1863,7008,3.5,16.5,24413,6174,18239,11.5,45.3,-15542,-28.8,33,0,907,907,3288
2009,07,e) 4,6345,6366,43555,45960,292,4.3,1201,17.7,6342,1041,5301,2.3,13.8,11742,4427,7315,9.6,25.5,-5400,-11.7,27.6,0,691,691,2795
2009,07,f) 5,5625,5654,57889,50794,280,4.7,921,15.5,24855,1106,23749,2.2,48.9,10920,4096,6824,8.1,21.5,13935,27.4,43,0,493,493,2411
2009,07,g) 6 to 10,22742,22988,192091,204583,922,3.8,3162,13.2,26588,4498,22090,2.2,13,52722,20163,32559,9.9,25.8,-26134,-12.8,26,0,1603,1603,13931
2009,07,h) 11 to 15,15805,16645,155164,162835,586,3.4,1819,10.6,16608,4025,12583,2.5,10.2,32555,9351,23204,5.7,20,-15947,-9.8,20.4,0,860,860,4827
2009,07,i) 16 to 20,12604,12853,148431,151228,500,3.8,1285,9.7,25281,3948,21333,2.6,16.7,31450,8412,23038,5.6,20.8,-6169,-4.1,33.4,0,604,604,4152
2009,07,j) 21 to 25,8428,8709,95619,98871,376,4.2,749,8.4,9613,2318,7295,2.3,9.7,16244,3825,12419,3.9,16.4,-6631,-6.7,19.4,0,407,407,2420
2009,07,k) 26+,6749,7047,91379,94873,170,2.4,529,7.3,7158,1392,5766,1.5,7.5,14375,3349,11026,3.5,15.2,-7217,-7.7,15,0,299,299,2300
2009,07,l) Left Censored,4776,6892,142772,145712,303,4.4,428,6.2,16192,6099,10093,4.2,11.1,22123,6096,16027,4.2,15.2,-5931,-4.1,22.2,0,193,193,1594
2009,10,a) 0,1766,1769,14404,7202,1751,198,0,0,14286,14286,0,198.4,198.4,0,0,0,0,0,14286,198.4,0,0,,,
2009,10,b) 1,1492,1525,16525,16587,14,0.8,461,26.4,5695,,,,34.3,5819,3612,2207,21.8,35.1,-124,-0.8,68.6,1,346,346,3287
2009,10,c) 2,1426,1440,16975,18153,36,2.3,301,19.2,3078,,,,17,5746,2562,3184,14.1,31.7,-2668,-14.7,34,1,222,222,2244
2009,10,d) 3,1278,1340,20747,22657,31,2.2,220,15.4,3378,510,2868,2.3,14.9,7249,2638,4611,11.6,32,-3871,-17.1,29.8,0,161,161,2192
2009,10,e) 4,889,932,13817,14407,20,2,137,13.9,2342,229,2113,1.6,16.3,3562,1009,2553,7,24.7,-1220,-8.4,32.6,0,99,99,825
2009,10,f) 5,736,759,14116,14092,19,2.4,105,13.2,2376,82,2294,0.6,16.9,2413,488,1925,3.5,17.1,-37,-0.2,33.8,0,73,73,400
2009,10,g) 6 to 10,2796,2923,43558,44879,80,2.7,284,9.4,6889,2148,4741,4.8,15.4,9691,2099,7592,4.7,21.6,-2802,-6.2,30.8,0,196,196,1733
2009,10,h) 11 to 15,2131,2359,40437,41793,64,2.6,262,10.7,5997,436,5561,1,14.3,8783,2319,6464,5.5,21,-2786,-6.7,28.6,0,122,122,942
2009,10,i) 16 to 20,1739,2080,43193,43605,148,7,213,10.1,8991,3152,5839,7.2,20.6,9991,4233,5758,9.7,22.9,-1000,-2.3,41.2,0,96,96,533
2009,10,j) 21 to 25,1492,1737,29462,30973,54,3.1,121,6.9,3737,1440,2297,4.6,12.1,6812,1001,5811,3.2,22,-3075,-9.9,24.2,0,81,81,699
2009,10,k) 26+,1936,2798,64467,67129,115,4.1,183,6.5,8660,2052,6608,3.1,12.9,14021,3085,10936,4.6,20.9,-5361,-8,25.8,0,83,83,633
2009,10,l) Left Censored,2180,6098,303543,301837,391,6.5,327,5.4,38358,9655,28703,3.2,12.7,35598,7958,27640,2.6,11.8,2760,0.9,23.6,0,87,87,752
2009,15,a) 0,19302,19317,83954,41977,18735,194,0,0,81639,81639,0,194.5,194.5,0,0,0,0,0,81639,194.5,0,0,,,
2009,15,b) 1,18173,18222,90889,106001,0,0,10567,45,21759,0,21759,0,20.5,51982,30023,21959,28.3,49,-30223,-28.5,41,0,7336,7336,22160
2009,15,c) 2,17846,17857,92817,108548,870,4.2,7221,34.6,18760,2517,16243,2.3,17.3,51126,23988,27138,22.1,47.1,-32366,-29.8,34.6,0,5038,5038,18133
2009,15,d) 3,18270,18379,106950,124023,847,4,6423,30.6,18023,2742,15281,2.2,14.5,53117,20752,32365,16.7,42.8,-35094,-28.3,29,0,4382,4382,15296
2009,15,e) 4,16789,16888,112007,128141,691,3.6,5085,26.8,17800,3130,14670,2.4,13.9,50692,16875,33817,13.2,39.6,-32892,-25.7,27.8,0,3430,3430,12358
2009,15,f) 5,14796,14845,98456,111801,610,3.7,4291,25.9,14851,1808,13043,1.6,13.3,42545,14788,27757,13.2,38.1,-27694,-24.8,26.6,0,2752,2752,10763
2009,15,g) 6 to 10,85168,85591,648131,728259,2973,3.2,18836,20.3,82204,9747,72457,1.3,11.3,245947,66633,179314,9.1,33.8,-163743,-22.5,22.6,0,11363,11372,45133
2009,15,h) 11 to 15,77232,77638,688472,771689,2291,2.8,13170,15.9,74488,8195,66293,1.1,9.7,243404,53898,189506,7,31.5,-168916,-21.8,19.4,0,7656,7656,36523
2009,15,i) 16 to 20,54509,54814,582567,645600,1502,2.6,7868,13.6,53368,5333,48035,0.8,8.3,180798,30166,150632,4.7,28,-127430,-19.7,16.6,0,4322,4322,19326
2009,15,j) 21 to 25,43955,44443,565005,625740,1013,2.2,5873,12.6,49618,5092,44526,0.8,7.9,172164,29121,143043,4.7,27.5,-122546,-19.6,15.8,0,3221,3221,16444
2009,15,k) 26+,35092,35996,576679,629511,766,2,4116,10.9,50325,5139,45186,0.8,8,156624,20232,136392,3.2,24.9,-106299,-16.9,16,0,2365,2365,12161
2009,15,l) Left Censored,34062,38758,1227158,1318542,622,1.6,3153,7.9,108330,11812,96518,0.9,8.2,291919,27274,264645,2.1,22.1,-183589,-13.9,16.4,0,1920,1920,10222
2009,20,a) 0,11697,11759,136994,68497,11565,196.7,0,0,135381,135381,0,197.6,197.6,0,0,0,0,0,135381,197.6,0,0,1,1,0
2009,20,b) 1,10776,10859,118239,135365,14,0.1,3535,28,27058,798,26260,0.6,20,61310,36449,24861,26.9,45.3,-34252,-25.3,40,0,2690,2691,30953
2009,20,c) 2,10546,10613,101678,114667,254,2.2,2704,23,16049,2427,13622,2.1,14,42460,20911,21549,18.2,37,-26411,-23,28,0,2088,2089,17653
2009,20,d) 3,10681,10947,135452,148366,262,2.2,2258,19,15887,1936,13951,1.3,10.7,42717,16851,25866,11.4,28.8,-26830,-18.1,21.4,0,1733,1735,13247
2009,20,e) 4,9598,9750,122157,134903,215,2.1,1746,16.7,13527,3645,9882,2.7,10,39993,13633,26360,10.1,29.6,-26466,-19.6,20,0,1340,1343,11212
2009,20,f) 5,8772,9011,128916,140342,185,1.9,1406,14.7,13101,2482,10619,1.8,9.3,36362,11145,25217,7.9,25.9,-23261,-16.6,18.6,0,1057,1058,8322
2009,20,g) 6 to 10,37631,38473,576743,624089,782,1.9,4878,12.1,51950,11429,40521,1.8,8.3,148564,40842,107722,6.5,23.8,-96614,-15.5,16.6,0,3504,3504,31456
2009,20,h) 11 to 15,31997,33420,576658,623644,688,2,3506,10.1,41508,7488,34020,1.2,6.7,136564,31525,105039,5.1,21.9,-95056,-15.2,13.4,0,2368,2370,21821
2009,20,i) 16 to 20,25865,27917,616523,662670,683,2.4,2630,9.1,43694,10462,33232,1.6,6.6,136751,31272,105479,4.7,20.6,-93057,-14,13.2,0,1705,1709,16595
2009,20,j) 21 to 25,23449,26011,870967,933838,434,1.6,1954,7.3,54274,12849,41425,1.4,5.8,181083,34735,146348,3.7,19.4,-126809,-13.6,11.6,0,1283,1286,16895
2009,20,k) 26+,24951,30197,1286273,1368070,476,1.5,1973,6.4,73876,14075,59801,1,5.4,238317,42805,195512,3.1,17.4,-164441,-12,10.8,0,1227,1230,18657
2009,20,l) Left Censored,43530,83210,8175622,8599671,1686,2,4348,5.1,485301,89460,395841,1,5.6,1336864,231887,1104977,2.7,15.5,-851563,-9.9,11.2,0,1636,1645,42065
2009,40,a) 0,16802,17009,80492,40246,16618,195.4,0,0,79500,79500,0,197.5,197.5,0,0,0,0,0,79500,197.5,0,0,,,
2009,40,b) 1,14433,14650,79736,86725,4,0,6306,35.4,19197,,,,22.1,33174,20751,12423,23.9,38.3,-13977,-16.2,44.2,1,4581,4600,16391
2009,40,c) 2,12957,13113,77755,83646,435,3,3797,25.9,13907,,,,16.6,26386,12954,13432,15.5,31.5,-12479,-14.9,33.2,1,2828,2828,10371
2009,40,d) 3,11681,12258,93999,100737,416,3.1,3050,22.6,14511,1568,12943,1.6,14.4,28569,13847,14722,13.7,28.4,-14058,-14,28.8,0,2288,2288,10362
2009,40,e) 4,10097,10453,89026,96230,333,2.9,2254,19.9,12918,3048,9870,3.2,13.4,27767,10301,17466,10.7,28.9,-14849,-15.5,26.8,0,1638,1638,8175
2009,40,f) 5,8634,8906,78221,83491,237,2.5,1789,18.6,9570,1120,8450,1.3,11.5,20547,8096,12451,9.7,24.6,-10977,-13.1,23,0,1317,1317,6301
2009,40,g) 6 to 10,34410,37911,397255,415958,1155,2.9,5772,14.4,47928,9768,38160,2.3,11.5,87408,32230,55178,7.7,21,-39480,-9.5,23,0,3958,3962,23833
2009,40,h) 11 to 15,24313,27423,357067,372735,769,2.7,3348,11.7,34114,6828,27286,1.8,9.2,66556,20408,46148,5.5,17.9,-32442,-8.7,18.4,0,2242,2258,14468
2009,40,i) 16 to 20,15967,18607,306806,320055,598,3.1,1991,10.3,28855,7072,21783,2.2,9,55841,16792,39049,5.2,17.4,-26986,-8.4,18,0,1231,1255,9570
2009,40,j) 21 to 25,11639,19152,442030,455602,1018,5.2,1581,8.2,47028,22597,24431,5,10.3,75123,18563,56560,4.1,16.5,-28095,-6.2,20.6,0,799,799,6719
2009,40,k) 26+,10273,36839,1059094,1104508,2705,7.2,3751,10,109548,43793,65755,4,9.9,201508,38601,162907,3.5,18.2,-91960,-8.3,19.8,0,606,612,7062
2009,40,l) Left Censored,14571,79106,3370503,3427485,6382,8.1,6431,8.1,308375,109027,199348,3.2,9,422942,99243,323699,2.9,12.3,-114567,-3.3,18,0,502,599,7711
2009,50,a) 0,18620,18741,88170,44085,18361,195.9,0,0,86214,86214,0,195.6,195.6,0,0,0,0,0,86214,195.6,0,0,,,
2009,50,b) 1,16220,16370,82041,92353,17,0.1,5523,28.9,17770,454,17316,0.5,19.2,38393,23583,14810,25.5,41.6,-20623,-22.4,38.4,0,3990,3990,19865
2009,50,c) 2,14819,15093,80063,86870,404,2.4,3833,23,13513,1205,12308,1.4,15.6,27850,14734,13116,17,32.1,-14337,-16.5,31.2,0,2862,2862,11850
2009,50,d) 3,14942,15806,103778,109205,424,2.5,3077,18.1,14342,1392,12950,1.3,13.1,26285,11110,15175,10.2,24.1,-11943,-11,26.2,0,2327,2328,8728
2009,50,e) 4,13789,14222,95727,101186,294,1.9,2604,17,13341,1999,11342,2,13.2,24847,10548,14299,10.4,24.6,-11506,-11.4,26.4,0,1965,1965,8035
2009,50,f) 5,12427,13003,95824,101806,276,2,1990,14.4,11265,1563,9702,1.5,11.1,23663,9745,13918,9.6,23.2,-12398,-12.1,22.2,0,1472,1472,8026
2009,50,g) 6 to 10,51830,55980,509247,536008,1141,1.9,6930,11.8,54116,7578,46538,1.4,10.1,109215,37158,72057,6.9,20.4,-55099,-10.3,20.2,0,4790,4800,26109
2009,50,h) 11 to 15,43185,45782,449920,470973,899,1.9,4647,9.8,42491,6829,35662,1.4,9,85527,23542,61985,5,18.2,-43036,-9.2,18,0,3088,3089,16474
2009,50,i) 16 to 20,34218,37199,448333,467369,667,1.7,3282,8.5,41607,4597,37010,1,8.9,80446,20709,59737,4.4,17.2,-38839,-8.3,17.8,0,2108,2112,13899
2009,50,j) 21 to 25,28494,36422,596357,617127,720,1.9,2436,6.5,41764,7968,33796,1.3,6.8,84031,19234,64797,3.1,13.6,-42267,-6.8,13.6,0,1578,1580,12207
2009,50,k) 26+,29105,45669,830746,858931,1214,2.6,2614,5.6,67072,20355,46717,2.4,7.8,128672,28084,100588,3.3,15,-61600,-7.2,15.6,0,1382,1399,10256
2009,50,l) Left Censored,42853,128822,3132388,3210277,6337,4.9,6543,5.1,302486,94865,207621,3,9.4,460228,115763,344465,3.6,14.3,-157742,-4.9,18.8,0,1549,1559,19333
2009,52,a) 0,93832,95064,740701,370351,93293,196.3,0,0,733325,733325,0,198,198,0,0,0,0,0,733325,198,0,0,,,
2009,52,b) 1,79056,80874,677190,778702,153,0.2,28287,29.8,121138,3058,118080,0.4,15.6,324161,165828,158333,21.3,41.6,-203023,-26,31.2,0,22571,22595,140117
2009,52,c) 2,68115,69568,594285,660341,1836,2.4,18323,23.7,78565,10648,67917,1.6,11.9,216077,111167,104910,16.8,32.7,-137512,-20.8,23.8,0,15110,15116,96731
2009,52,d) 3,62366,66256,607574,659576,1774,2.5,14443,20,70478,10872,59606,1.6,10.7,177870,86651,91219,13.1,27,-107392,-16.3,21.4,0,11770,11779,73550
2009,52,e) 4,54475,57573,543959,586248,1502,2.4,11088,17.9,62826,14668,48158,2.5,10.7,150287,66329,83958,11.3,25.6,-87461,-14.9,21.4,0,8977,8984,54117
2009,52,f) 5,45687,49032,465055,501571,1197,2.3,8773,16.7,49573,7300,42273,1.5,9.9,124648,55365,69283,11,24.9,-75075,-15,19.8,0,7007,7037,45050
2009,52,g) 6 to 10,167865,184961,1946399,2071045,4436,2.3,25179,12.9,189321,37001,152320,1.8,9.1,446738,170968,275770,8.3,21.6,-257417,-12.5,18.2,0,19165,19354,134194
2009,52,h) 11 to 15,113188,132574,1607419,1681693,3588,2.6,13478,9.8,157827,42327,115500,2.5,9.4,311121,94948,216173,5.6,18.5,-153294,-9.1,18.8,0,9876,9947,68739
2009,52,i) 16 to 20,77857,105466,1460539,1514483,2642,2.4,8700,8,137635,39640,97995,2.6,9.1,250238,66536,183702,4.4,16.5,-112603,-7.4,18.2,0,5914,5973,45586
2009,52,j) 21 to 25,59710,96867,1730986,1796104,2873,2.9,6009,6.1,154434,55166,99268,3.1,8.6,286064,52582,233482,2.9,15.9,-131630,-7.3,17.2,0,3948,3981,31966
2009,52,k) 26+,58365,129673,2577312,2649833,4173,3.2,6323,4.8,214434,76996,137438,2.9,8.1,361049,62733,298316,2.4,13.6,-146615,-5.5,16.2,0,3434,3497,26513
2009,52,l) Left Censored,67451,410202,11570638,11754901,16647,4.1,14215,3.5,950440,351886,598554,3,8.1,1323466,215479,1107987,1.8,11.3,-373026,-3.2,16.2,0,3386,3827,37542
2009,60,a) 0,32669,33147,139289,69645,32317,195,0,0,137438,137438,0,197.3,197.3,0,0,0,0,0,137438,197.3,0,0,,,
2009,60,b) 1,28979,29964,137391,158487,20,0.1,12650,34.9,33085,213,32872,0.1,20.9,75276,43901,31375,27.7,47.5,-42191,-26.6,41.8,0,9079,9082,35019
2009,60,c) 2,27735,28594,127628,139936,1048,3.2,9164,28.3,21775,2911,18864,2.1,15.6,47515,28823,18692,20.6,34,-25740,-18.4,31.2,0,6720,6720,21073
2009,60,d) 3,26709,29304,143641,153433,1097,3.4,7869,24.2,21390,2795,18595,1.8,13.9,41880,22821,19059,14.9,27.3,-20490,-13.4,27.8,0,5665,5735,18487
2009,60,e) 4,23584,26241,128110,137549,926,3.2,6135,21.4,20748,3332,17416,2.4,15.1,40383,19718,20665,14.3,29.4,-19635,-14.3,30.2,0,4356,4357,14663
2009,60,f) 5,20838,21715,110646,118067,698,3,4698,19.9,15422,1811,13611,1.5,13.1,31150,14731,16419,12.5,26.4,-15728,-13.3,26.2,0,3347,3347,11336
2009,60,g) 6 to 10,80216,90567,611970,645832,3162,3.3,14591,15.2,79579,19664,59915,3,12.3,150051,68832,81219,10.7,23.2,-70472,-10.9,24.6,0,9679,9689,46478
2009,60,h) 11 to 15,54182,63561,505560,532813,2024,3.1,7279,11,56717,11452,45265,2.1,10.6,112597,38646,73951,7.3,21.1,-55880,-10.5,21.2,0,4709,4804,22141
2009,60,i) 16 to 20,38401,49566,424198,437298,1945,3.8,4194,8.3,46088,11378,34710,2.6,10.5,73967,22325,51642,5.1,16.9,-27879,-6.4,21,0,2511,2515,11052
2009,60,j) 21 to 25,32502,47703,451693,457518,1747,3.6,3822,7.9,50532,14763,35769,3.2,11,63592,19562,44030,4.3,13.9,-13060,-2.9,22,0,1891,1906,7115
2009,60,k) 26+,31332,55422,629509,643998,2205,3.9,3724,6.6,70708,29351,41357,4.6,11,100508,30714,69794,4.8,15.6,-29800,-4.6,22,0,1653,2026,8879
2009,60,l) Left Censored,46953,243505,4699509,4796968,17006,7,19472,8,521255,203295,317960,4.2,10.9,718121,192315,525806,4,15,-196866,-4.1,21.8,0,1751,1956,18225
2009,70,a) 0,189475,190840,1018920,509460,186673,195.6,0,0,1005352,1005352,0,197.3,197.3,0,0,0,0,0,1005352,197.3,0,0,2,2,0
2009,70,b) 1,165433,166907,1074277,1125093,210,0.1,57913,29.6,280372,4624,275748,0.4,24.9,382004,204114,177890,18.1,34,-101632,-9.1,49.8,0,40208,40227,160445
2009,70,c) 2,151161,152499,1159588,1222053,4723,2.8,36687,22,209080,19513,189567,1.6,17.1,343420,161536,181884,13.2,28.1,-134340,-11,34.2,0,25948,25953,128111
2009,70,d) 3,144004,149328,1234331,1301623,4649,2.9,28818,18,192791,20703,172088,1.6,14.8,333070,133366,199704,10.2,25.6,-140279,-10.8,29.6,0,20285,20295,102946
2009,70,e) 4,127321,130696,1224494,1287248,3747,2.7,22852,16.4,182013,27194,154819,2.1,14.1,313546,125249,188297,9.7,24.4,-131533,-10.3,28.2,0,16144,16160,89317
2009,70,f) 5,112590,115197,1065246,1129419,3071,2.5,18390,15.1,134788,13221,121567,1.2,11.9,268573,99548,169025,8.8,23.8,-133785,-11.9,23.8,0,12746,12752,78704
2009,70,g) 6 to 10,406396,428737,5076428,5288003,10864,2.4,50856,11.4,568282,73080,495202,1.4,10.7,1008684,336592,672092,6.4,19.1,-440402,-8.4,21.4,0,34084,34167,237575
2009,70,h) 11 to 15,277017,304637,4098966,4250695,8221,2.6,27955,8.9,429262,74420,354842,1.8,10.1,742801,195224,547577,4.6,17.5,-313539,-7.4,20.2,0,17679,17715,129842
2009,70,i) 16 to 20,194741,225438,3472628,3588451,6411,2.8,17822,7.7,367482,77332,290150,2.2,10.2,608143,134472,473671,3.7,16.9,-240661,-6.7,20.4,0,10886,10889,71521
2009,70,j) 21 to 25,184337,229139,4770791,4854088,5722,2.5,14048,6,429391,107714,321677,2.2,8.8,601043,145184,455859,3,12.4,-171652,-3.6,17.6,0,8140,8165,64577
2009,70,k) 26+,162930,247145,5787194,5882406,7442,3,14293,5.7,571059,137126,433933,2.3,9.7,765814,165543,600271,2.8,13,-194755,-3.3,19.4,0,7226,7314,44320
2009,70,l) Left Censored,207569,422503,17371037,17610947,18228,4.3,27240,6.4,1465373,347512,1117861,2,8.3,1959601,439981,1519620,2.5,11.1,-494228,-2.8,16.6,0,6910,6954,64237
2010,07,a) 0,9291,9308,45811,22906,9308,200,0,0,45811,,,,200,0,0,0,0,0,45811,200,0,1,,,
2010,07,b) 1,7069,7080,52400,48584,1,0,2985,34.8,23350,,,,48.1,15717,7973,7744,16.4,32.4,7633,15.7,64.8,1,1630,1630,4713
2010,07,c) 2,7707,7740,44089,45989,654,7.8,1838,22.1,10169,3141,7028,6.8,22.1,13968,6784,7184,14.8,30.4,-3799,-8.3,44.2,0,1038,1038,4527
2010,07,d) 3,6960,6961,38462,47253,631,8.6,1389,18.9,7643,1991,5652,4.2,16.2,25224,4800,20424,10.2,53.4,-17581,-37.2,32.4,0,785,785,2975
2010,07,e) 4,6880,6926,43894,45105,553,7.6,1159,16,8077,2133,5944,4.7,17.9,10499,4246,6253,9.4,23.3,-2422,-5.4,35.8,0,642,642,2389
2010,07,f) 5,5858,5878,41366,42361,399,6.5,884,14.4,7604,1213,6391,2.9,18,9594,4561,5033,10.8,22.6,-1990,-4.6,36,0,509,509,2904
2010,07,g) 6 to 10,23005,23206,186185,199462,1420,5.9,2808,11.7,32338,11603,20735,5.8,16.2,58891,11104,47787,5.6,29.5,-26553,-13.3,32.4,0,1487,1487,6428
2010,07,h) 11 to 15,16477,16800,151791,153759,941,5.5,1615,9.4,22026,4710,17316,3.1,14.3,25962,7216,18746,4.7,16.9,-3936,-2.6,28.6,0,810,810,3984
2010,07,i) 16 to 20,12601,13386,150090,155572,676,5,1140,8.4,20871,4264,16607,2.7,13.4,31834,13670,18164,8.8,20.5,-10963,-7.1,26.8,0,524,524,2915
2010,07,j) 21 to 25,8831,9111,95890,98194,342,3.7,705,7.6,9691,1500,8191,1.5,9.9,14298,3769,10529,3.8,14.6,-4607,-4.7,19.8,0,350,350,2227
2010,07,k) 26+,7860,8184,109673,111191,238,2.9,500,6,11218,1297,9921,1.2,10.1,14253,3451,10802,3.1,12.8,-3035,-2.7,20.2,0,266,266,2234
2010,07,l) Left Censored,4591,6789,134553,137298,220,3.2,330,4.8,14146,3550,10596,2.6,10.3,19636,5814,13822,4.2,14.3,-5490,-4,20.6,0,184,184,2515
2010,10,a) 0,1327,1363,14885,7443,1363,200,0,0,14885,,,,200,0,0,0,0,0,14885,200,0,1,,,
2010,10,b) 1,1312,1324,11977,13971,3,0.2,457,29.5,2717,,,,19.4,6705,4281,2424,30.6,48,-3988,-28.6,38.8,1,330,330,3400
2010,10,c) 2,1218,1243,15828,16111,57,4.1,336,24.3,3892,578,3314,3.6,24.2,4458,2290,2168,14.2,27.7,-566,-3.5,48.4,0,239,239,1620
2010,10,d) 3,1219,1243,14245,15781,49,3.6,251,18.7,2049,408,1641,2.6,13,5120,1999,3121,12.7,32.4,-3071,-19.4,26,0,186,186,1687
2010,10,e) 4,1102,1203,18921,19405,81,6.4,215,16.9,4228,1626,2602,8.4,21.8,5195,2291,2904,11.8,26.8,-967,-5,43.6,0,139,139,1930
2010,10,f) 5,789,843,12439,13020,42,4.7,128,14.4,2095,523,1572,4,16.1,3256,918,2338,7.1,25,-1161,-8.9,32.2,0,93,93,626
2010,10,g) 6 to 10,2814,2937,46873,48273,115,3.7,386,12.6,8144,2809,5335,5.8,16.9,10943,4354,6589,9,22.7,-2799,-5.8,33.8,0,276,276,3851
2010,10,h) 11 to 15,2089,2198,29915,33019,79,3.5,180,8,3080,412,2668,1.2,9.3,9287,3801,5486,11.5,28.1,-6207,-18.8,18.6,0,119,119,1386
2010,10,i) 16 to 20,1742,2233,41527,42623,140,6.2,162,7.2,6054,1583,4471,3.7,14.2,8246,1575,6671,3.7,19.3,-2192,-5.1,28.4,0,74,74,511
2010,10,j) 21 to 25,1457,1697,32382,33042,68,4,98,5.7,3470,768,2702,2.3,10.5,4789,1187,3602,3.6,14.5,-1319,-4,21,0,58,58,684
2010,10,k) 26+,2166,3092,67272,67870,181,5.8,199,6.4,11544,5067,6477,7.5,17,12740,3531,9209,5.2,18.8,-1196,-1.8,34,0,85,85,1307
2010,10,l) Left Censored,2110,6037,293107,298362,319,5.3,329,5.4,33592,7214,26378,2.4,11.3,44101,6809,37292,2.3,14.8,-10509,-3.5,22.6,0,66,66,976
2010,15,a) 0,16744,16782,72857,36429,16782,200,0,0,72857,,,,200,0,0,0,0,0,72857,200,0,1,,,
2010,15,b) 1,12709,12726,66201,74970,2,0,6595,41.2,18266,,,,24.4,35804,20321,15483,27.1,47.8,-17538,-23.4,48.8,1,4458,4458,14975
2010,15,c) 2,14520,14563,80284,85130,1393,8.5,5044,30.8,24007,3760,20247,4.4,28.2,33699,18172,15527,21.3,39.6,-9692,-11.4,56.4,0,3471,3471,14340
2010,15,d) 3,14624,14635,75727,83927,1342,8.3,4559,28.1,16751,3948,12803,4.7,20,33150,14778,18372,17.6,39.5,-16399,-19.5,40,0,3014,3014,10923
2010,15,e) 4,15328,15415,88954,97706,1333,7.9,4282,25.4,17608,3275,14333,3.4,18,35111,14759,20352,15.1,35.9,-17503,-17.9,36,0,2745,2751,10493
2010,15,f) 5,14179,14281,90893,101369,1091,7,3696,23.7,16158,3139,13019,3.1,15.9,37110,13893,23217,13.7,36.6,-20952,-20.7,31.8,0,2393,2393,10382
2010,15,g) 6 to 10,72327,72691,517691,561087,4989,6.4,14970,19.3,84962,16460,68502,2.9,15.1,171753,52319,119434,9.3,30.6,-86791,-15.5,30.2,0,8982,8982,36332
2010,15,h) 11 to 15,73108,73563,614267,655965,3918,5,12143,15.6,92216,12900,79316,2,14.1,175611,44613,130998,6.8,26.8,-83395,-12.7,28.2,0,7019,7019,29163
2010,15,i) 16 to 20,52897,53236,528309,564200,2623,4.7,7386,13.3,66527,10432,56095,1.8,11.8,138309,28930,109379,5.1,24.5,-71782,-12.7,23.6,0,4168,4168,19461
2010,15,j) 21 to 25,43558,43950,497620,529769,1998,4.4,5494,12,63491,10872,52619,2.1,12,127788,20786,107002,3.9,24.1,-64297,-12.1,24,0,3059,3059,13549
2010,15,k) 26+,39312,40356,611782,651308,1387,3.3,4360,10.4,69685,7814,61871,1.2,10.7,148736,23283,125453,3.6,22.8,-79051,-12.1,21.4,0,2525,2525,15408
2010,15,l) Left Censored,32106,36665,1096395,1162156,916,2.4,2913,7.7,116487,13838,102649,1.2,10,248009,30300,217709,2.6,21.3,-131522,-11.3,20,0,1698,1698,13932
2010,20,a) 0,10379,10457,114622,57311,10457,200,0,0,114622,114622,0,200,200,0,0,0,0,0,114622,200,0,0,,,
2010,20,b) 1,8827,8895,98501,115176,23,0.2,2819,27.4,19778,950,18828,0.8,17.2,53127,33095,20032,28.7,46.1,-33349,-28.9,34.4,0,2149,2149,30452
2010,20,c) 2,9022,9089,99565,107634,428,4.3,2157,21.7,17549,2958,14591,2.7,16.3,33687,19192,14495,17.8,31.3,-16138,-15,32.6,0,1705,1705,15877
2010,20,d) 3,9106,9169,90133,94786,468,4.7,1897,19.2,15160,2743,12417,2.9,16,24466,12501,11965,13.2,25.8,-9306,-9.8,32,0,1451,1451,10308
2010,20,e) 4,9303,9572,120163,127257,400,3.9,1752,17.1,14937,3079,11858,2.4,11.7,29124,11811,17313,9.3,22.9,-14187,-11.2,23.4,0,1338,1338,9307
2010,20,f) 5,8561,8698,110013,115158,335,3.6,1362,14.8,14382,2838,11544,2.5,12.5,24672,9758,14914,8.5,21.4,-10290,-8.9,25,0,1027,1027,7951
2010,20,g) 6 to 10,35873,36760,542517,563915,1318,3.4,4645,12.1,61784,12344,49440,2.2,11,104579,37115,67464,6.6,18.5,-42795,-7.5,22,0,3410,3410,28861
2010,20,h) 11 to 15,31031,32279,534036,553861,1037,3.1,3258,9.8,50436,9171,41265,1.7,9.1,90086,28271,61815,5.1,16.3,-39650,-7.2,18.2,0,2338,2340,20512
2010,20,i) 16 to 20,24977,27108,577179,597817,858,3.1,2475,8.9,49529,9861,39668,1.6,8.3,90804,23137,67667,3.9,15.2,-41275,-6.9,16.6,0,1631,1632,14490
2010,20,j) 21 to 25,23170,25383,765672,794433,596,2.3,1857,7.1,63456,9879,53577,1.2,8,120977,28315,92662,3.6,15.2,-57521,-7.2,16,0,1300,1302,14482
2010,20,k) 26+,27722,33257,1342252,1395262,655,1.9,2056,6.1,89696,14278,75418,1,6.4,195715,41204,154511,3,14,-106019,-7.6,12.8,0,1355,1359,18784
2010,20,l) Left Censored,41662,79771,7595927,7842341,1511,1.9,3732,4.6,462657,71312,391345,0.9,5.9,955486,194714,760772,2.5,12.2,-492829,-6.3,11.8,0,1649,1685,34124
2010,40,a) 0,15008,15384,87780,43890,15384,200,0,0,87780,87780,0,200,200,0,0,0,0,0,87780,200,0,0,,,
2010,40,b) 1,12089,12302,71642,76703,19,0.1,4715,32.2,17741,490,17251,0.6,23.1,27862,16034,11828,20.9,36.3,-10121,-13.2,46.2,0,3492,3495,12865
2010,40,c) 2,12136,12346,72407,75497,815,6,3098,23,15590,3498,12092,4.6,20.6,21770,11047,10723,14.6,28.8,-6180,-8.2,41.2,0,2324,2324,9088
2010,40,d) 3,11074,11216,69709,73165,701,5.8,2594,21.3,12379,2367,10012,3.2,16.9,19290,11064,8226,15.1,26.4,-6911,-9.5,33.8,0,1912,1912,9250
2010,40,e) 4,10146,10692,82777,87846,586,5.1,2127,18.6,12294,2201,10093,2.5,14,22431,10898,11533,12.4,25.5,-10137,-11.5,28,0,1545,1545,8604
2010,40,f) 5,8973,9372,85056,86714,553,5.6,1615,16.3,16681,5361,11320,6.2,19.2,19997,7899,12098,9.1,23.1,-3316,-3.9,38.4,0,1162,1162,6370
2010,40,g) 6 to 10,33523,36542,366012,377315,1969,5.2,5071,13.3,48592,11818,36774,3.1,12.9,71198,28382,42816,7.5,18.9,-22606,-6,25.8,0,3583,3583,22452
2010,40,h) 11 to 15,24461,28225,372769,380645,1206,4.1,3027,10.4,43316,14309,29007,3.8,11.4,59067,19720,39347,5.2,15.5,-15751,-4.1,22.8,0,2049,2049,14704
2010,40,i) 16 to 20,16220,18513,286524,295354,768,4,1859,9.8,37945,8156,29789,2.8,12.8,55605,16105,39500,5.5,18.8,-17660,-6,25.6,0,1184,1201,8374
2010,40,j) 21 to 25,11921,17941,408709,422752,747,4.1,1470,8,36013,10866,25147,2.6,8.5,64099,17191,46908,4.1,15.2,-28086,-6.7,17,0,733,748,8054
2010,40,k) 26+,11502,37819,1073881,1090594,1688,4.4,3254,8.4,107694,22836,84858,2.1,9.9,141121,41712,99409,3.8,12.9,-33427,-3,19.8,0,644,650,8539
2010,40,l) Left Censored,14101,79267,3236250,3297007,6306,8,5369,6.8,275588,92785,182803,2.8,8.4,397102,119862,277240,3.6,12,-121514,-3.6,16.8,0,467,475,7596
2010,50,a) 0,18475,18695,85360,42680,18695,200,0,0,85360,85360,0,200,200,0,0,0,0,0,85360,200,0,0,,,
2010,50,b) 1,14289,14412,80521,84428,23,0.1,4338,26.2,20357,415,19942,0.5,24.1,28171,16904,11267,20,33.4,-7814,-9.3,48.2,0,3172,3172,14118
2010,50,c) 2,13828,13964,75239,79461,741,4.9,3131,20.7,14981,3243,11738,4.1,18.9,23424,10785,12639,13.6,29.5,-8443,-10.6,37.8,0,2399,2403,8833
2010,50,d) 3,12968,13246,74619,77538,680,4.8,2550,18,12994,2454,10540,3.2,16.8,18832,8925,9907,11.5,24.3,-5838,-7.5,33.6,0,1907,1907,7063
2010,50,e) 4,13223,13974,94655,98672,589,4,2282,15.4,13387,2559,10828,2.6,13.6,21421,8052,13369,8.2,21.7,-8034,-8.1,27.2,0,1738,1738,6527
2010,50,f) 5,12333,12756,89383,92323,505,3.7,1959,14.5,13108,2113,10995,2.3,14.2,18988,7958,11030,8.6,20.6,-5880,-6.4,28.4,0,1464,1464,6246
2010,50,g) 6 to 10,50465,54649,486149,500845,1904,3.3,6415,11.3,60627,11369,49258,2.3,12.1,90018,33827,56191,6.8,18,-29391,-5.9,24.2,0,4596,4597,25892
2010,50,h) 11 to 15,41796,44481,419885,434113,1649,3.6,4262,9.3,46542,10909,35633,2.5,10.7,74997,22696,52301,5.2,17.3,-28455,-6.6,21.4,0,2903,2907,16400
2010,50,i) 16 to 20,33699,36737,430227,441466,1047,2.8,2961,7.9,38625,7492,31133,1.7,8.7,61103,16657,44446,3.8,13.8,-22478,-5.1,17.4,0,1987,1989,12299
2010,50,j) 21 to 25,28182,34497,554444,564389,818,2.3,2423,6.9,49688,8345,41343,1.5,8.8,69578,16073,53505,2.8,12.3,-19890,-3.5,17.6,0,1536,1549,10537
2010,50,k) 26+,32622,50939,893324,913778,1271,2.5,2688,5.2,78324,21491,56833,2.4,8.6,119231,26265,92966,2.9,13,-40907,-4.4,17.2,0,1422,1440,13774
2010,50,l) Left Censored,41030,126577,2975399,3040978,5439,4.3,5816,4.6,279013,95644,183369,3.1,9.2,410171,94956,315215,3.1,13.5,-131158,-4.3,18.4,0,1454,1510,17979
2010,52,a) 0,91429,92903,740158,370079,92903,200,0,0,740158,740158,0,200,200,0,0,0,0,0,740158,200,0,0,,,
2010,52,b) 1,71101,72394,617625,678601,117,0.1,22790,27.2,110489,2338,108151,0.3,16.3,232440,132123,100317,19.5,34.3,-121951,-18,32.6,0,18114,18155,113500
2010,52,c) 2,66869,68652,594943,635424,3249,4.3,15449,20.7,88514,18151,70363,2.9,13.9,169475,93418,76057,14.7,26.7,-80961,-12.8,27.8,0,12749,12754,82016
2010,52,d) 3,58658,60063,524207,558562,2531,3.9,12012,18.5,70571,13508,57063,2.4,12.6,139281,77473,61808,13.9,24.9,-68710,-12.3,25.2,0,9855,9866,67686
2010,52,e) 4,54773,58750,554834,580920,2408,3.9,9841,15.8,67577,14279,53298,2.5,11.6,119749,59118,60631,10.2,20.6,-52172,-9,23.2,0,7981,7986,50351
2010,52,f) 5,48350,51286,495713,519581,1849,3.4,8009,14.7,59272,10835,48437,2.1,11.4,107007,51308,55699,9.9,20.6,-47735,-9.2,22.8,0,6459,6495,44131
2010,52,g) 6 to 10,169805,185887,1905602,1975727,6601,3.4,22526,11.6,204875,46248,158627,2.3,10.4,345124,141887,203237,7.2,17.5,-140249,-7.1,20.8,0,17018,17051,114266
2010,52,h) 11 to 15,113968,134391,1587321,1630713,4545,3.3,12045,8.7,156111,41757,114354,2.6,9.6,242894,82447,160447,5.1,14.9,-86783,-5.3,19.2,0,8700,8741,63145
2010,52,i) 16 to 20,78232,99696,1345772,1388424,2960,2.9,7461,7.3,124070,31852,92218,2.3,8.9,209373,64187,145186,4.6,15.1,-85303,-6.2,17.8,0,5280,5314,43543
2010,52,j) 21 to 25,60137,97814,1558702,1589242,2785,2.8,5546,5.6,135559,38343,97216,2.4,8.5,196639,43695,152944,2.7,12.4,-61080,-3.9,17,0,3432,3491,27210
2010,52,k) 26+,65565,145525,2967578,2977956,4339,3,6366,4.3,263349,70111,193238,2.4,8.8,284104,58101,226003,2,9.5,-20755,-0.7,17.6,0,3202,3427,27264
2010,52,l) Left Censored,64496,402496,11191147,11303832,13763,3.4,12494,3.1,819138,257521,561617,2.3,7.2,1044508,157464,887044,1.4,9.2,-225370,-2,14.4,0,2769,2969,29185
2010,60,a) 0,31338,32203,134093,67047,32203,200,0,0,134093,134093,0,200,200,0,0,0,0,0,134093,200,0,0,,,
2010,60,b) 1,24334,25201,114758,127896,424,1.5,8324,28.6,24999,2437,22562,1.9,19.5,51274,30851,20423,24.1,40.1,-26275,-20.6,39,0,6185,6185,25645
2010,60,c) 2,24649,25542,115417,122504,1544,5.6,5958,21.5,21724,4190,17534,3.4,17.7,35898,20535,15363,16.8,29.3,-14174,-11.6,35.4,0,4476,4477,16559
2010,60,d) 3,24380,25211,114419,119190,1652,6.1,5017,18.7,19873,5394,14479,4.5,16.7,29415,14297,15118,12,24.7,-9542,-8,33.4,0,3735,3735,11464
2010,60,e) 4,23905,26543,131531,137770,1787,6.4,4513,16.2,19333,5309,14024,3.9,14,31811,13323,18488,9.7,23.1,-12478,-9.1,28,0,3231,3246,10556
2010,60,f) 5,21082,23637,118652,122601,1599,6.5,3860,15.6,18761,5401,13360,4.4,15.3,26659,11099,15560,9.1,21.7,-7898,-6.4,30.6,0,2727,2752,8530
2010,60,g) 6 to 10,80172,88979,549218,570999,4516,4.9,11350,12.3,69848,19281,50567,3.4,12.2,113409,45740,67669,8,19.9,-43561,-7.7,24.4,0,7903,7926,33284
2010,60,h) 11 to 15,55344,65129,499093,515429,2724,4.1,6705,10,61268,20422,40846,4,11.9,93940,33749,60191,6.5,18.2,-32672,-6.3,23.8,0,4106,4113,19057
2010,60,i) 16 to 20,38573,48724,419180,427536,1876,3.8,3448,7,43738,10942,32796,2.6,10.2,60449,15113,45336,3.5,14.1,-16711,-3.9,20.4,0,2302,2303,9195
2010,60,j) 21 to 25,32338,45479,418199,423205,2678,5.9,2891,6.3,51717,21551,30166,5.1,12.2,61729,21625,40104,5.1,14.6,-10012,-2.4,24.4,0,1566,1570,8805
2010,60,k) 26+,35707,64613,703121,717165,3548,5.5,4048,6.2,99541,46244,53297,6.4,13.9,127629,39154,88475,5.5,17.8,-28088,-3.9,27.8,0,1657,1664,7374
2010,60,l) Left Censored,45452,234992,4474861,4572866,14601,6.2,19386,8.2,523125,157241,365884,3.4,11.4,719136,205113,514023,4.5,15.7,-196011,-4.3,22.8,0,1427,1464,14999
2010,70,a) 0,178736,181723,1072918,536459,181723,200,0,0,1072918,1072918,0,200,200,0,0,0,0,0,1072918,200,0,0,,,
2010,70,b) 1,143746,145168,966999,989680,187,0.1,45846,27.3,244497,6288,238209,0.6,24.7,289859,163540,126319,16.5,29.3,-45362,-4.6,49.4,0,32277,32280,128126
2010,70,c) 2,142311,143912,1014829,1042656,8228,5.3,31135,20,215857,33115,182742,3.2,20.7,271510,142403,129107,13.7,26,-55653,-5.3,41.4,0,22667,22685,113062
2010,70,d) 3,133249,134587,1079982,1116633,7349,5.1,25186,17.6,183621,27085,156536,2.4,16.4,256923,122557,134366,11,23,-73302,-6.6,32.8,0,18069,18076,101594
2010,70,e) 4,129348,134847,1151843,1189970,7169,5,21471,15.1,184488,30570,153918,2.6,15.5,260742,110549,150193,9.3,21.9,-76254,-6.4,31,0,15135,15136,88473
2010,70,f) 5,115300,118607,1138955,1178682,5688,4.6,17727,14.2,167753,24794,142959,2.1,14.2,247206,103107,144099,8.7,21,-79453,-6.8,28.4,0,12388,12395,79971
2010,70,g) 6 to 10,418838,437646,4835757,4954357,18766,4.1,49739,11,632172,110174,521998,2.2,12.8,869372,297464,571908,6,17.5,-237200,-4.7,25.6,0,33788,33802,225898
2010,70,h) 11 to 15,283864,314235,4319345,4373113,12535,3.9,27762,8.6,526849,142887,383962,3.3,12,634384,195539,438845,4.5,14.5,-107535,-2.5,24,0,17627,17697,137154
2010,70,i) 16 to 20,196872,225164,3285504,3333298,8834,3.9,16511,7.2,372219,85847,286372,2.6,11.2,467806,133281,334525,4,14,-95587,-2.8,22.4,0,10345,10352,84172
2010,70,j) 21 to 25,164814,207877,4532598,4556041,7876,3.7,12202,5.8,430333,124804,305529,2.7,9.4,477220,113959,363261,2.5,10.5,-46887,-1.1,18.8,0,7285,7331,53342
2010,70,k) 26+,203857,297673,6595840,6600205,11527,3.8,15023,5,692561,191596,500965,2.9,10.5,701290,163808,537482,2.5,10.6,-8729,-0.1,21,0,7814,7917,61627
2010,70,l) Left Censored,201389,415792,17341333,17345058,20869,5,22963,5.5,1622836,470872,1151964,2.7,9.4,1630288,360793,1269495,2.1,9.4,-7452,0,18.8,0,6377,6431,80742
2011,07,a) 0,9659,9699,41299,20650,9699,200,0,0,41299,,,,200,0,0,0,0,0,41299,200,0,1,,,
2011,07,b) 1,6474,6498,39048,42285,1,0,2808,35.5,8362,,,,19.8,14835,9584,5251,22.7,35.1,-6473,-15.3,39.6,1,1772,1772,6111
2011,07,c) 2,6257,6273,37757,44996,540,8.1,1337,20,8311,1992,6319,4.4,18.5,22788,5477,17311,12.2,50.6,-14477,-32.1,37,0,871,871,2779
2011,07,d) 3,6989,7023,41601,42789,589,8,1295,17.6,8795,1824,6971,4.3,20.6,11170,5437,5733,12.7,26.1,-2375,-5.5,41.2,0,856,856,3121
2011,07,e) 4,6360,6361,36818,37635,508,7.6,1105,16.6,7574,1537,6037,4.1,20.1,9207,4843,4364,12.9,24.5,-1633,-4.4,40.2,0,716,716,2619
2011,07,f) 5,6387,6433,42660,43270,471,7.1,961,14.4,8118,2662,5456,6.2,18.8,9337,3566,5771,8.2,21.6,-1219,-2.8,37.6,0,589,589,2575
2011,07,g) 6 to 10,23113,23307,177909,183023,1451,6,3056,12.7,28580,5401,23179,3,15.6,38808,14199,24609,7.8,21.2,-10228,-5.6,31.2,0,1908,1909,9005
2011,07,h) 11 to 15,16899,17187,163401,164998,938,5.3,1716,9.8,25554,5518,20036,3.3,15.5,28747,8813,19934,5.3,17.4,-3193,-1.9,31,0,1040,1040,5235
2011,07,i) 16 to 20,12027,12878,139978,141708,570,4.3,1116,8.5,18046,5417,12629,3.8,12.7,21506,6471,15035,4.6,15.2,-3460,-2.5,25.4,0,661,661,3823
2011,07,j) 21 to 25,9863,10172,112489,111551,473,4.6,843,8.1,16373,2784,13589,2.5,14.7,14497,4541,9956,4.1,13,1876,1.7,26,0,507,507,3102
2011,07,k) 26+,9006,9348,124069,125533,280,2.9,649,6.8,12356,1924,10432,1.5,9.8,15283,4221,11062,3.4,12.2,-2927,-2.4,19.6,0,426,426,3033
2011,07,l) Left Censored,4391,6732,134475,134153,295,4.4,342,5.1,17540,4885,12655,3.6,13.1,16896,3137,13759,2.3,12.6,644,0.5,25.2,0,196,196,1272
2011,10,a) 0,1674,1709,19893,9947,1709,200,0,0,19893,19893,0,200,200,0,0,0,0,0,19893,200,0,0,,,
2011,10,b) 1,1051,1092,15443,15215,6,0.5,281,22.9,5247,230,5017,1.5,34.5,4791,1732,3059,11.4,31.5,456,3,63,0,215,215,1410
2011,10,c) 2,1177,1189,12370,11756,68,5.4,199,15.9,3777,188,3589,1.6,32.1,2548,1640,908,14,21.7,1229,10.4,43.4,0,181,181,1592
2011,10,d) 3,1115,1147,17482,16343,94,7.9,189,15.8,5652,625,5027,3.8,34.6,3373,1659,1714,10.2,20.6,2279,14,41.2,0,154,159,1521
2011,10,e) 4,1111,1138,15259,14626,65,5.5,168,14.1,3935,439,3496,3,26.9,2669,1228,1441,8.4,18.2,1266,8.7,36.4,0,138,138,1069
2011,10,f) 5,1038,1146,22232,20249,87,7.4,136,11.6,7752,1447,6305,7.1,38.3,3786,2575,1211,12.7,18.7,3966,19.6,37.4,0,108,113,2091
2011,10,g) 6 to 10,2930,3066,55144,52934,144,4.6,337,10.7,12931,2593,10338,4.9,24.4,8510,2898,5612,5.5,16.1,4421,8.3,32.2,0,277,277,2200
2011,10,h) 11 to 15,2031,2192,33943,33305,71,3.2,192,8.5,5869,447,5422,1.3,17.6,4592,1751,2841,5.3,13.8,1277,3.8,27.6,0,150,153,1646
2011,10,i) 16 to 20,1719,2038,32290,31484,92,4.4,153,7.4,6125,868,5257,2.8,19.5,4513,1114,3399,3.5,14.3,1612,5.2,28.6,0,109,111,808
2011,10,j) 21 to 25,1421,1826,49007,46553,101,5.5,133,7.2,8422,1472,6950,3.2,18.1,3513,877,2636,1.9,7.5,4909,10.6,15,0,80,80,511
2011,10,k) 26+,2351,3377,79148,75293,178,5.2,241,7.1,16440,4386,12054,5.8,21.8,8729,2452,6277,3.3,11.6,7711,10.2,23.2,0,147,147,589
2011,10,l) Left Censored,2036,5982,306226,300158,292,4.9,300,5,42245,8737,33508,2.9,14.1,30109,5962,24147,2,10,12136,4.1,20,0,88,89,1856
2011,15,a) 0,16913,16923,88291,44146,16923,200,0,0,88291,88291,0,200,200,0,0,0,0,0,88291,200,0,0,,,
2011,15,b) 1,11404,11440,62987,68359,0,0,5342,37.9,18314,0,18314,0,26.8,29058,16709,12349,24.4,42.5,-10744,-15.7,53.6,0,3957,3957,13234
2011,15,c) 2,10750,10766,63692,64716,1009,8.6,2964,25.2,19488,3427,16061,5.3,30.1,21535,10283,11252,15.9,33.3,-2047,-3.2,60.2,0,2228,2228,8408
2011,15,d) 3,12561,12600,77780,79032,1248,9.2,3209,23.6,18402,3120,15282,3.9,23.3,20905,10113,10792,12.8,26.5,-2503,-3.2,46.6,0,2345,2345,8064
2011,15,e) 4,12747,12758,69860,72790,1340,9.8,3216,23.5,17443,3479,13964,4.8,24,23302,11365,11937,15.6,32,-5859,-8,48,0,2304,2304,9223
2011,15,f) 5,13618,13691,81515,85020,1361,9.4,3074,21.1,17306,4073,13233,4.8,20.4,24316,9841,14475,11.6,28.6,-7010,-8.2,40.8,0,2163,2168,7623
2011,15,g) 6 to 10,63259,63691,448360,467542,4967,7.4,11929,17.8,85800,14297,71503,3.1,18.4,124163,44203,79960,9.5,26.6,-38363,-8.2,36.8,0,8132,8134,33915
2011,15,h) 11 to 15,69264,69734,578617,599532,4285,5.9,10735,14.7,95640,11510,84130,1.9,16,137470,40931,96539,6.8,22.9,-41830,-6.9,32,0,7087,7091,30632
2011,15,i) 16 to 20,51667,51913,500077,517316,2619,4.8,7162,13.2,73183,7481,65702,1.4,14.1,107661,28194,79467,5.5,20.8,-34478,-6.7,28.2,0,4721,4726,21959
2011,15,j) 21 to 25,42960,43619,468582,485085,2338,5.2,5389,11.9,65026,9952,55074,2.1,13.4,98032,20776,77256,4.3,20.2,-33006,-6.8,26.8,0,3524,3525,15528
2011,15,k) 26+,43726,44875,662502,685790,1669,3.6,4817,10.4,85362,6712,78650,1,12.4,131938,24631,107307,3.6,19.2,-46576,-6.8,24.8,0,3267,3270,15871
2011,15,l) Left Censored,30098,34652,1044013,1072146,871,2.4,2809,7.9,135366,11796,123570,1.1,12.6,191631,25641,165990,2.4,17.9,-56265,-5.3,25.2,0,1900,1905,13342
2011,20,a) 0,11073,11169,120228,60114,11169,200,0,0,120228,120228,0,200,200,0,0,0,0,0,120228,200,0,0,1,1,0
2011,20,b) 1,8073,8165,94878,104208,34,0.4,2289,24.6,23420,1955,21465,1.9,22.5,42080,29109,12971,27.9,40.4,-18660,-17.9,45,0,1903,1904,26918
2011,20,c) 2,7773,7849,92907,94510,416,5,1422,17,19442,2768,16674,2.9,20.6,22648,14181,8467,15,24,-3206,-3.4,41.2,0,1217,1217,13517
2011,20,d) 3,8055,8134,96016,97976,423,4.9,1373,15.9,18773,4581,14192,4.7,19.2,22693,10452,12241,10.7,23.2,-3920,-4,38.4,0,1193,1196,9967
2011,20,e) 4,8199,8289,89271,88234,433,5,1322,15.1,17408,3380,14028,3.8,19.7,15334,7685,7649,8.7,17.4,2074,2.3,34.8,0,1109,1110,7089
2011,20,f) 5,8511,8774,118571,118733,404,4.4,1194,13,18034,2363,15671,2,15.2,18357,8914,9443,7.5,15.5,-323,-0.3,30.4,0,1007,1008,8047
2011,20,g) 6 to 10,34933,35829,556319,554053,1351,3.6,4002,10.8,80420,12120,68300,2.2,14.5,75888,33030,42858,6,13.7,4532,0.8,27.4,0,3272,3274,27913
2011,20,h) 11 to 15,30369,31616,535863,529501,1088,3.4,2804,8.6,71524,12068,59456,2.3,13.5,58799,21007,37792,4,11.1,12725,2.4,22.2,0,2197,2198,17437
2011,20,i) 16 to 20,24423,25849,554195,547336,785,3,2013,7.6,66868,11358,55510,2.1,12.2,53149,18260,34889,3.3,9.7,13719,2.5,19.4,0,1599,1602,14456
2011,20,j) 21 to 25,22382,24894,729570,727455,815,3.2,1881,7.4,76046,14273,61773,2,10.5,71815,25603,46212,3.5,9.9,4231,0.6,19.8,0,1287,1305,13891
2011,20,k) 26+,31006,36980,1544135,1528190,789,2.1,2144,5.7,157038,29706,127332,1.9,10.3,125148,39227,85921,2.6,8.2,31890,2.1,16.4,0,1564,1575,25530
2011,20,l) Left Censored,40145,77393,7553363,7559560,1552,2,3174,4.1,566718,78267,488451,1,7.5,579112,149335,429777,2,7.7,-12394,-0.2,15,0,1608,1758,44820
2011,40,a) 0,19126,19318,101937,50969,19318,200,0,0,101937,101937,0,200,200,0,0,0,0,0,101937,200,0,0,,,
2011,40,b) 1,10935,11299,75478,80909,24,0.2,4088,30.7,18990,919,18071,1.1,23.5,29851,19002,10849,23.5,36.9,-10861,-13.4,47,0,3333,3333,15282
2011,40,c) 2,10245,10457,70599,70456,656,5.8,2476,21.8,16780,2313,14467,3.3,23.8,16494,9406,7088,13.4,23.4,286,0.4,46.8,0,2101,2102,8496
2011,40,d) 3,10523,10728,70653,70825,692,6,2298,19.9,15694,3038,12656,4.3,22.2,16038,9341,6697,13.2,22.6,-344,-0.4,44.4,0,1940,1940,8274
2011,40,e) 4,9897,10058,69205,69345,668,6.3,1814,17.1,13501,2543,10958,3.7,19.5,13781,7012,6769,10.1,19.9,-280,-0.4,39,0,1466,1467,5900
2011,40,f) 5,9144,9682,84008,84021,581,5.7,1570,15.4,15103,3041,12062,3.6,18,15129,7323,7806,8.7,18,-26,0,36,0,1283,1284,6117
2011,40,g) 6 to 10,33593,36172,372581,371418,2079,5.6,4632,12.4,58904,12500,46404,3.4,15.9,56577,22551,34026,6.1,15.2,2327,0.7,30.4,0,3714,3727,19230
2011,40,h) 11 to 15,24475,29310,397877,393350,1850,6.2,3010,10.1,53462,13061,40401,3.3,13.6,44408,15759,28649,4,11.3,9054,2.3,22.6,0,2156,2159,11526
2011,40,i) 16 to 20,16327,18406,294469,292129,780,4.1,1734,9.2,41875,10749,31126,3.7,14.3,37195,11185,26010,3.8,12.7,4680,1.6,25.4,0,1288,1288,8370
2011,40,j) 21 to 25,12280,16853,331155,327955,745,4.4,1227,7.2,39485,11532,27953,3.5,12,33085,9945,23140,3,10.1,6400,1.9,20.2,0,825,843,5946
2011,40,k) 26+,12903,38581,1171329,1165475,3179,8.2,3312,8.6,149364,55029,94335,4.7,12.8,137656,48376,89280,4.2,11.8,11708,1,23.6,0,751,767,6820
2011,40,l) Left Censored,13596,81583,3294620,3282426,6357,7.9,4735,5.9,302994,97501,205493,3,9.2,278606,64077,214529,2,8.5,24388,0.7,17,0,536,554,10261
2011,50,a) 0,18832,18974,89700,44850,18974,200,0,0,89700,89700,0,200,200,0,0,0,0,0,89700,200,0,0,,,
2011,50,b) 1,14330,14564,76890,81571,24,0.1,4148,24.9,18775,599,18176,0.7,23,28136,17022,11114,20.9,34.5,-9361,-11.5,46,0,3381,3381,14580
2011,50,c) 2,12432,12540,69551,75389,608,4.5,2473,18.4,13671,1816,11855,2.4,18.1,25346,14784,10562,19.6,33.6,-11675,-15.5,36.2,0,2074,2075,13056
2011,50,d) 3,12315,12521,76372,75673,673,5.1,2116,16,15014,2933,12081,3.9,19.8,13616,7270,6346,9.6,18,1398,1.8,36,0,1771,1771,6447
2011,50,e) 4,11635,11901,73886,73783,568,4.5,1909,15.2,14647,1789,12858,2.4,19.9,14441,7397,7044,10,19.6,206,0.3,39.2,0,1555,1555,6507
2011,50,f) 5,11963,12708,92689,93351,543,4.1,1800,13.5,14603,2471,12132,2.6,15.6,15926,7813,8113,8.4,17.1,-1323,-1.5,31.2,0,1443,1446,6467
2011,50,g) 6 to 10,50105,53960,475007,478550,1939,3.5,5904,10.6,60725,8860,51865,1.9,12.7,67810,26803,41007,5.6,14.2,-7085,-1.5,25.4,0,4589,4595,22230
2011,50,h) 11 to 15,40096,42966,430373,430398,1449,3.3,3947,8.9,54271,10681,43590,2.5,12.6,54320,19936,34384,4.6,12.6,-49,0,25.2,0,2928,2940,15550
2011,50,i) 16 to 20,33072,36001,416255,419604,1029,2.8,2835,7.7,41877,6269,35608,1.5,10,48574,16468,32106,3.9,11.6,-6697,-1.6,20,0,2119,2123,12280
2011,50,j) 21 to 25,28003,33829,545647,545175,764,2.2,2192,6.3,56881,6953,49928,1.3,10.4,55936,19229,36707,3.5,10.3,945,0.1,20.6,0,1543,1557,11612
2011,50,k) 26+,36290,56492,986260,986884,2378,4.2,3026,5.3,101667,24472,77195,2.5,10.3,102915,25900,77015,2.6,10.4,-1248,-0.1,20.6,0,1805,1836,12683
2011,50,l) Left Censored,39336,124936,3023883,2991610,4358,3.5,4708,3.8,349099,92192,256907,3.1,11.7,284553,66142,218411,2.2,9.5,64546,2.2,19,0,1463,1617,23453
2011,52,a) 0,95584,97589,785051,392526,97589,200,0,0,785051,785051,0,200,200,0,0,0,0,0,785051,200,0,0,,,
2011,52,b) 1,69595,71165,631397,686041,268,0.3,22037,26.9,126458,6274,120184,0.9,18.4,235745,131966,103779,19.2,34.4,-109287,-16,36.8,0,19147,19225,119668
2011,52,c) 2,60816,62205,562874,589375,3021,4.5,13177,19.6,89288,18150,71138,3.1,15.1,142290,77713,64577,13.2,24.1,-53002,-9,30.2,0,11753,11767,71205
2011,52,d) 3,57886,59668,548527,570856,2366,3.7,11287,17.6,77639,14079,63560,2.5,13.6,122296,67892,54404,11.9,21.4,-44657,-7.8,27.2,0,9969,9974,61862
2011,52,e) 4,51672,53065,489001,506351,2112,3.7,9085,16.1,66556,12138,54418,2.4,13.1,101255,54175,47080,10.7,20,-34699,-6.9,26.2,0,7926,7940,48993
2011,52,f) 5,48829,52628,523114,538492,1889,3.4,7895,14.2,65140,11995,53145,2.2,12.1,95896,45832,50064,8.5,17.8,-30756,-5.7,24.2,0,6682,6719,39316
2011,52,g) 6 to 10,173500,189390,1968225,2010292,6583,3.3,22737,11.5,233871,51763,182108,2.6,11.6,318005,141485,176520,7,15.8,-84134,-4.2,23.2,0,19175,19265,122917
2011,52,h) 11 to 15,114426,136005,1628843,1651403,4371,3.1,12257,8.8,177062,38093,138969,2.3,10.7,222181,84484,137697,5.1,13.5,-45119,-2.8,21.4,0,9715,9761,69111
2011,52,i) 16 to 20,77880,96030,1317647,1333529,2891,2.9,7690,7.8,130339,26666,103673,2,9.8,162102,53083,109019,4,12.2,-31763,-2.4,19.6,0,5991,6108,43232
2011,52,j) 21 to 25,60182,98600,1587170,1564263,2796,2.8,5878,5.9,193160,40010,153150,2.6,12.3,147345,41803,105542,2.7,9.4,45815,2.9,18.8,0,4072,4235,29186
2011,52,k) 26+,72767,159871,3279318,3264672,5119,3.2,6732,4.2,295428,76597,218831,2.3,9,266136,53695,212441,1.6,8.2,29292,0.8,16.4,0,4214,4461,33485
2011,52,l) Left Censored,61307,400150,11245875,11162423,15647,3.9,11234,2.8,1004233,280081,724152,2.5,9,837328,148260,689068,1.3,7.5,166905,1.5,15,0,3131,3433,31811
2011,60,a) 0,31200,31778,139907,69954,31778,200,0,0,139907,139907,0,200,200,0,0,0,0,0,139907,200,0,0,3,3,0
2011,60,b) 1,23371,24298,101173,117241,116,0.4,7990,28.3,22281,1801,20480,1.5,19,54417,32814,21603,28,46.4,-32136,-27.4,38,0,6323,6330,28995
2011,60,c) 2,20999,21989,108744,111549,1206,5.1,4389,18.6,22028,2887,19141,2.6,19.7,27637,16080,11557,14.4,24.8,-5609,-5.1,39.4,0,3597,3597,11665
2011,60,d) 3,21766,22678,110140,112494,1232,5.1,4057,16.8,20439,4442,15997,3.9,18.2,25147,12469,12678,11.1,22.4,-4708,-4.2,36.4,0,3224,3224,10635
2011,60,e) 4,21872,22671,104873,109035,1305,5.5,3795,15.9,16560,4470,12090,4.1,15.2,24884,13337,11547,12.2,22.8,-8324,-7.6,30.4,0,2982,2986,11351
2011,60,f) 5,21550,24156,124036,126650,1400,5.5,3671,14.5,17676,4637,13039,3.7,14,22903,10664,12239,8.4,18.1,-5227,-4.1,28,0,2816,2816,8499
2011,60,g) 6 to 10,80816,90424,538735,549575,4328,4.6,11187,11.9,71236,15503,55733,2.8,13,92916,41313,51603,7.5,16.9,-21680,-3.9,26,0,8378,8400,32476
2011,60,h) 11 to 15,55656,65610,492030,502819,2780,4.1,6398,9.5,60630,16563,44067,3.3,12.1,82208,33227,48981,6.6,16.3,-21578,-4.2,24.2,0,4654,4688,21975
2011,60,i) 16 to 20,38066,47251,412553,413275,1947,4,3796,7.9,47180,14938,32242,3.6,11.4,48624,16279,32345,3.9,11.8,-1444,-0.4,22.8,0,2735,2743,11259
2011,60,j) 21 to 25,31786,44463,413631,413191,1920,4.3,3019,6.7,54068,22563,31505,5.5,13.1,53188,20321,32867,4.9,12.9,880,0.2,25.8,0,2063,2090,9080
2011,60,k) 26+,39868,71284,775064,779610,2865,4,4731,6.6,83334,34646,48688,4.4,10.7,92426,25283,67143,3.2,11.9,-9092,-1.2,21.4,0,2244,2397,10066
2011,60,l) Left Censored,43759,234061,4529757,4499657,16751,7.2,15618,6.7,560323,193377,366946,4.3,12.5,500123,149001,351122,3.3,11.1,60200,1.4,22.2,0,1735,1920,17909
2011,70,a) 0,185463,186812,1085067,542534,186812,200,0,0,1085067,,,,200,0,0,0,0,0,1085067,200,0,1,1,1,0
2011,70,b) 1,136344,139427,1037384,1055502,333,0.2,42495,26.5,282654,,,,26.8,318889,174292,144597,16.5,30.2,-36235,-3.4,53.6,1,33344,33349,150019
2011,70,c) 2,126418,127883,949867,950097,7213,5.3,24351,17.8,212475,28169,184306,3,22.4,212934,116362,96572,12.2,22.4,-459,0,44.8,0,19530,19534,103603
2011,70,d) 3,127603,129255,989140,996977,7170,5.3,21734,15.9,187144,25141,162003,2.5,18.8,202817,99821,102996,10,20.3,-15673,-1.5,37.6,0,17360,17370,83937
2011,70,e) 4,121020,122285,1059797,1063644,6816,5.3,18930,14.7,192971,22717,170254,2.1,18.1,200664,87262,113402,8.2,18.9,-7693,-0.8,36.2,0,14827,14829,69939
2011,70,f) 5,118145,123448,1141789,1143215,6243,4.8,17422,13.5,188087,26193,161894,2.3,16.5,190938,84845,106093,7.4,16.7,-2851,-0.2,33,0,13425,13443,71574
2011,70,g) 6 to 10,435092,452936,4930227,4960418,20090,4.3,51113,10.9,716316,118938,597378,2.4,14.4,776697,295247,481450,6,15.7,-60381,-1.3,28.8,0,39059,39119,241053
2011,70,h) 11 to 15,287400,317984,4532863,4555260,12531,3.8,27574,8.5,548931,103256,445675,2.3,12.1,593724,199194,394530,4.4,13,-44793,-0.9,24.2,0,20313,20389,160653
2011,70,i) 16 to 20,198901,225512,3256619,3278635,8548,3.7,17375,7.6,374391,98017,276374,3,11.4,418422,112013,306409,3.4,12.8,-44031,-1.4,22.8,0,12402,12442,79579
2011,70,j) 21 to 25,160436,198465,4416463,4395101,6676,3.3,13481,6.7,460726,97644,363082,2.2,10.5,418002,131044,286958,3,9.5,42724,1,19,0,9027,9074,79856
2011,70,k) 26+,227534,333002,7483000,7436241,11130,3.3,18235,5.4,782660,169521,613139,2.3,10.5,689141,146597,542544,2,9.3,93519,1.2,18.6,0,11471,11647,65915
2011,70,l) Left Censored,194243,407797,17670023,17465145,19390,4.7,20534,5,1904006,410315,1493691,2.3,10.9,1494250,322105,1172145,1.8,8.6,409756,2.3,17.2,0,7831,8246,99636
